bancqouilinocq	ilinek
konfilis	kofilis
renchoufonsier	fosier
realamant	realamant
Daoulinet	daoulinet
voallaviuz	gwallavius
dinac'h	dinac'h
drebiou	drebiou
ren	aeren
bandeu	bandev
berdallan	peurzalla
houret	eoreteoriet
marc'hed	marc'het
A	kel
dieubi	dieubi
ariolen	riolenn
tardemant	tardamant
consoluz	kosolus
erhoalh	rwalc'h
listriavrezel	lestrbrezel
Lusquemanteu	luskamant
nezadegou	nezadeg
peulvanou	peulvan
disentamant	disentamant
disouillet	disouilha
urgrollers	korollerez
lenn	lenn
kamz	kamz
noazpidiboulc'h	noazhpidiboulc'h
vincius	visius
tremeniad	tremeniad
bernvarvern	bernwarvern
slen	soulenn
goalguemeret	gwallgemeret
ollpur	hollbur
abaoepellamzer	amzer
lprus	lepruz
klanvaet	klavaet
divoaz	divoas
dourneohdourne	dornouzhdorn
ramplus	ramplus
stryou	str
carantenez	karantenez
aguetanrah	agentarazh
arvousellenvoan	bouzellennvoan
asprena	asprena
taouen	taouen
acouragein	akouraji
ravoderez	ravoderezh
glaouaer	glaouaerglaouer
qignezenned	kignezenn
cornouec	kornaoueg
sich	sich
scod	skod
rumadigueah	rummadigezh
moalet	moala
Clet	Klet
arVourc'hVenn	Bourc'hWenn
ganthan	auntu
skubunadou	skubennado
coantized	koantiz
tldrouk	taoldroug
annamad	annamat
bryata	briata
Symbolen	simbolenn
aziabarh	aziabarzh
disc'hlac'harin	disc'hlac'hari
gant	hanterahanteri
arhent	arhent
beonou	beon
fablenn	fablenn
enwadet	enwadet
enemscora	skora
kraounfao	kraofaou
seulave	seul
hadrei	adrei
riadeu	euriad
kigeret	kigeri
barriquad	barrikad
surtout	surtout
goalbeden	gwallbedenn
morbigmarellet	morbigmarellet
Fic'h	fic'h
pillerad	pilerad
reoll	reholl
Goez	gouez
avrhad	avrec'had
krot	krot
taneoc'h	tane
bromission	promision
chalounessou	chalones
divlas	divlaz
statudi	statudastatudi
tromplezon	tromplezon
Taran	taran
tomaat	tommaat
skouerbak	skouerbank
instituet	institua
arabet	Arab
emgannet	emgannaemganni
setm	setim
ablamzer	abellamzer
barvryen	barverbarvier
ino	eno
Beteghen	betekhenn
palarennou	palarenn
aventgand	avent
ampouezounet	ampoezonet
deurbiue	dourbev
trec'h	trec'h
Urhandatt	kantad
astafo	hastafo
erapin	rapinarapini
leinouryen	leiner
Souezuz	souezhus
eilgosa	eilkosha
berc'henna	perc'hennaperc'henni
drougpresegures	droukprezegerezh
lintrourou	lintrouer
eurc'hollad	kollad
kougouleet	kougoulaat
diskianteka	diskiantek
dic'hlaignet	dic'hlanniet
aziribis	aziribis
taran	taran
richen	richen
lienenaoter	aoter
reigolo	rei
calculi	kalkulakalkuli
orporched	dorborched
azilerc'h	azilerc'h
skridtamall	skridtamall
digourachi	digouraji
andruessa	truez
MariTereza	Tereza
diranget	dirajet
Truillennok	truilhennek
scep	skob
kardel	kardell
nadozet	nadozi
Petoare	petore
aziabarz	aziabarzh
dismanta	dismantradismantridismantr
skorpul	skorpul
divoursein	divoursadivoursi
cresserelle	kreserel
Eleonora	Eleonora
hunan	eunan
fourradou	fourrad
velfet	melc'hwed
karmelitezed	karmelitezed
zoken	zoken
iskuz	iskuz
padable	padapl
tourquet	tourked
efond	fontafonti
asederaas	sederaat
enemstartaat	startaat
esterloup	esterloup
diraizouni	direzoni
adrespar	adreistpar
votinesen	botinezenn
morlein	morlei
kuneheg	gwinizheg
lonchezrantel	lonkedrantell
Dinaturdet	dinaturded
Divrasa	divrazadivrazi
dioubarty	parti
Chomompablas	ablas
diar	dir
rei	rei
dourdiluch	dourdiluj
ur	parti
Skatek	skanteg
PaonPaon	pao
rioln	riolenn
aherzkaer	aharzkaer
Farcerez	farserezh
ed	bid
eizdezyeg	eizhteziek
poanio	poan
tranquilite	trankilite
ed	gagez
diahulccan	diavelek
pardaeznoz	pardaeznoz
corollers	korollerez
Eurc'hollpenn	kollpenn
suznryen	suner
posset	pozet
didach	didach
Tarieller	tarieller
Hei	hei
loui	luz
asteredennaz	steredennisteredenna
toullarBater	toullarbater
ranjemant	rajamant
Chormi	chormi
disclration	disklrasion
visgouilMikl	Mikael
diboniein	diboaniadiboanii
ehanavi	anavezoutanavoutanaout
hezibr	krommellenndibr
Rogasionou	rogasion
falscredennou	falskredenn
eurganen	kanenn
flojeal	flojeal
goz	gouez
toumptoumptoump	toump
patato	patato
diachap	diachap
Scosellec	skosellek
takounerez	takonerezh
marc'htaul	marc'htaol
pistiga	pistiga
annamiz	Annamad
livna	livna
lc'hlistri	lec'hlistri
lizerousyell	siell
humgollqit	koll
aziscamp	diskampa
gristenach	kristenaj
koulzovije	koulz
begad	begad
IaouBask	YaouBaskYaouFask
dizampouezouni	dizampoezoni
dizesk	dizesk
lipousiez	lipouziezh
lestrreder	lestrreder
Parea	parea
gwenodenn	gwenodenn
qenesqep	keneskob
sevennetmad	sevenet
solanelamant	solennelamant
ribin	ribin
adachadou	adachado
drailvein	drailhvein
vanil	vanilh
Abafet	abafet
arecommandas	rekomandi
souten	souten
takounet	takonet
kaoutkroaz	kroaz
tantationeu	tantasion
chansuz	chasus
frauder	floder
gabanen	kabanenn
kornouriez	kornouriez
mitik	mitig
cuzloar	kuzhloar
peniguen	pinijenn
vaille	vailh
dic'halloudez	dic'halloudezh
Gaouierez	gaouierezh
calzenn	kalzenn
tripoterez	tripoterezh
garinebet	garenebi
pogammed	pavgamm
chokat	chaokatchaokachaoki
epebhent	hent
bchekh	bechig
darc'ha	darc'ha
vindrail	mindrailh
digassendro	degasdegasi
gwarm	gwaremm
bremaik	bremaik
abephent	hent
labaskenn	labaskenn
randounen	randonenn
o	morad
delour	dleour
terriet	terriet
gevredizel	izel
librance	libras
marc'hitiout	marc'hyod
dizatren	dizantren
bezaechalo	chal
dadouez	dadouez
zic'hodella	dic'hodella
divouttonei	divountona
gouallvankout	gwallvankout
Pistaon	pistaon
zislea	dizlea
despeigni	despegni
lovradur	lovradur
dislonk	dislonk
ingal	ingal
gouilhed	goulh
havreqet	havrekaat
Borzcaer	PorzhKaer
bremaik	bremaik
humenidiguez	humenidigezh
Jfourna	iforna
Lambader	Lambader
ariolen	ariolenn
jaugeabl	jaojapl
ollc'halloudeg	hollc'halloudeg
estremded	estremded
dijunet	dijunidijunadijunia
mouralio	morailh
dizeur	dizeur
dibaotre	dibaotre
soubouldou	soubould
duta	tuta
torchennet	torchennet
barnerabeoc'h	barnerabeoc'h
azibreved	dibreveda
edok	edek
marc'hglaour	marc'hglaouaer
subeennei	soubenna
mailluret	mailhuret
Sterndor	sterndor
begajou	begad
penfolet	pennfollet
Gwic'hal	gwic'hal
diac'huz	diyac'hus
c'hoaritoulpouliq	toullpoullig
meiz	meizmez
urvaraen	baraenn
glazennek	glazennek
bloavechennou	bloavezhienno
asvoalc'hi	azgwalc'hi
abostoler	abostoler
diwikhofreetdiwikhewret	diwikefreet
urbrosen	prozenn
troc'hgoug	troc'hgouzoug
neket	neket
fumi	fumafumifumal
bourouz	bourouz
begad	begad
gwall	gwall
mestrdanz	mestrdas
skridou	skrid
Didrompein	didrompladidrompli
einebage	enebaj
man	mann
warvlar	warvlar
despeigni	despegni
mignaoual	mignaoual
Reed	reed
enemdizenoui	dizenoei
paboni	paboni
sargalon	sargalon
Ttebie	tetebietetedie
Lambader	Lambader
marc'hkulier	marc'hkulier
Doucig	dousik
distalav	distalaf
abasder	habaskter
Izkuz	iskuz
frak	frak
meuta	meuta
dleour	dleour
seitcvd	seitekvet
perrest	peurrest
gamdroyeu	kammdro
paguig	bag
neantet	neantet
melenuz	melenus
morvleizy	morvleiz
leinter	aoter
heuzaoeryen	heuzaouer
zaltin	saltin
diez	diaez
interior	interior
tivlat	teolad
lor	lore
mintinves	mintinvezh
sederd	sederaat
porscloz	porzhkloz
dirouestl	dirouestl
plantedigez	plantedigezh
teurel	steurel
spled	spled
Daleer	daleer
motennet	motennet
aizellea	izelaat
Taconeu	takon
olviscoh	ahollviskoazh
bifiga	pibida
receuerion	resever
dezinterez	dizinterest
pave	pavez
melhec	mellek
aubaden	aobadenn
arc'hdiakr	arc'hdiakr
Antifonennou	antifonenn
ali	ali
saotr	saotr
asecouro	sikoursikouri
everz	hewerzh
Glazenn	glazenn
pnnousqull	pennaskell
mougergoulou	mougergoulo
encoach	koach
spluzeg	splusegspuseg
Koulinez	koulinez
estig	eostig
intennein	intenni
temjo	temzio
divlaz	divlaz
visenadvnt	Azvent
dibrenest	dibrenestr
epebent	hent
mintinvez	mintinvezh
divouiek	diouiziek
Divet	divent
renoncereah	renoserezh
aaccord	akort
morvraguez	morwreg
benefi	penefi
Sentus	sentus
aziarvras	azirvras
biein	bezia
koreenno	korreenn
adolpadeu	adolpad(ig)o
falvin	fallvin
bevech	bewechbewezh
enemdivec'hiet	divec'hiadivec'hadivec'hi
naturel	naturel
aflao	flav
goaza	koazhakoazhi
plac'hedbihan	plac'hvihan
discreden	diskredenn
vantrebistac'h	vantrebistac'h
risk	risk
asgoalc'hit	azgwalc'hi
agorgammou	gourgamm
stlet	stalet
digloset	digloset
haddresset	addresa
agreistout	agreiztout
enemzieubi	dieubi
sqebeltousseg	skabelltouseg
zistrafuilla	distrafuilha
fionnage	fionaj
Lardtoas	larttoaz
livrour	levrer
distorlok	distorlok
arc'hlaskerienhoboud	klaskerevoued
Pa	pa
manioc	maniok
chiffein	chifachifalchifi
pentiec	penntieg
dadest	test
reclom	areklom
c'hoargaer	c'hoargaer
aretourn	aretorn
comparabl	komparapl
fuladen	fuladenn
crisset	kriset
demanaout	damanavezout
levenedigez	levenedigezh
traouillerou	traouilher
loskus	loskus
dislea	dizlea
diankenia	diankeniadiankenat
zouellerez	touellerezh
dichelpan	dichelpa
dreespont	spont
goalstad	gwallstad
isfount	isfont
arc'hlanvour	klavour
toulandar	toullandar
diodet	diodet
ahurlam	ac'hourlamm
goulaouideiz	goulaouideiz
Avloaszo	avloazzo
glizennoufresq	glizhenngwlizhenn
bragoniou	bragonio
sul	sul
astenngouzoug	astenngouzoug
multrr	muntrer
Fic'hellerez	fic'hellerezh
setuaze	setu
yonyan	noter
muiarmui	muirmui
dislonket	dislonket
chinad	sinaat
lizet	lizet
SandMartinis	SantMartiniz
evarikleze	marikleza
naguet	get
mouistet	mouestet
ampoesounerez	ampoezonerezh
Lodennek	lodennek
pennfoll	pennfoll
leurzi	leurzi
Aean	hage
digor	digor
vostad	avostad
gimaus	grimasus
Jakez	Jakez
ezaer'maeza	maez
devesque	davesk
dreeurred	red
Baluden	paludenn
flastr	flastr
tenzorier	tezoriertezorer
impar	ampar
davet	dovaet
Abad	abad
ankeniuz	ankeniusankenus
parbleur	parbleur
Modez	Maodez
andrevach	trevaj
arGroaz	kroaz
distreina	distreina
feizd'amdouchic	feizda'mdouchig
melodiussa	melodius
lardous	lardous
sklasi	sklasasklasi
eurwianen	gwianenn
Semennou	semenn
klor	klor
hadkoachet	adkoacha
vontaribgant	aribl
dana	tana
brein	brein
fuzillet	fuzuilha
Aketaou	ergentaou
didach	didach
Laou	Laou
sec'het	sec'het
ahurlam	gourlamm
brinnoni	breinoni
glazet	glazet
spound	spont
Kign	kign
bremaik	bremaik
eurc'hempen	kempenn
diskareo	diskaranhav
harluet	harluet
dinac'hiou	dinac'h
arumdarum	arummdarumm
c'hournaouog	kornaoueg
rebiz	rebiz
limage	limaj
zermounerrien	sarmoner
disjointret	disjoentret
limajeu	limaj
koattan	koadtan
divarzu	diwarzu
teurbellek	teurbelek
eurvouchenn	mouchenn
skedet	skeudi
libouz	liboust
c'hegilloutoull	kegeldoull
Hualou	hual
Brejed	brezet
fermoni	fermoni
tossenneg	tosennek
habilentez	abilentez
Complidou	komplido
Sembolen	simbolenn
o	arnod
erbouvor	pouvoer
divot	divot
eveljust	eveljust
touyereah	touerezh
ergenail	kanailh
procesi	proseziprosezal
tausseu	taos
gwall	gwall
tuffec	tufektufevek
nevez	nevez
touch	touch
eihdiat	eizhteziad
blazenn	blazenn
urbarti	parti
Europead	Europead
koadesk	koadesk
goao	goaf
kastorin	kastorin
fateit	fasataet
humvellein	mellamelli
misericord	mizerikord
disvempra	disvempra
avaman	avama
spountrak	spont
begatebet	begad
mouamant	mouvamant
Jaodreer	jaodrer
eurveurdez	meurdez
acolit	akolit
touyadelleu	touadell
varvailh	marvailh
enhuad	huadi
zioula	sioula
arvoderasion	moderasion
ispridet	ispridet
ograouet	ograoui
ageta	agenta
klostret	klostret
duta	tuta
diskoulm	diskoulmadiskoulm
d'audissalar	godisalgodisa
Kerne	KernevKerne
chomdagoza	kozhakozhi
eonuz	eonus
talvouduz	talvoudus
eurc'hourlonen	gourlenenn
flambyeu	flambev
Kazpin	kazhpin
koant	koant
coalgundu	gwallgundu
scrigndent	skrigndent
divinet	divini
wardaro	warzarev
adoulladou	adoullado
Klask	klask
coulined	koulin
coc'hennet	koc'hennet
arc'hournaouok	kornaoueg
sklent	sklent
leveourien	leveour
c'hoarvager	c'hoarvager
epinarz	espinard
glaouennet	glaouennet
famin	famin
kaolmeler	kaolmeler
kloc'hgalf	kloc'hgalv
tantationeu	tantasion
kousket	kousketkouski
neuennat	neuvennat
kefiada	kefiada
cess	ases
minoret	minoret
arvamc'hrizien	mammwrizienn
morliqin	morlikin
tintennenn	tintenenn
diamors	diamors
penturi	penturi
adaol	adaol
gouhlaitarw	koletarv
leuryouqarr	leurgarr
prezeg	preg
skarzeriengodellou	skarzhergodello
baotrezsaout	paotrezsaout
marnec'het	marnec'het
gouez	gouez
ollbaduz	hollbadus
arlicoed	arlikon
olbuissance	hollbuisas
sacot	chakot
degas	degasdegasi
saotr	saotr
bodennet	bodennet
Priol	priol
begad	begad
dilabour	dilabour
ahir	ahir
liboust	liboust
streilhou	streilh
Spgar	spegar
dreistholl	dreistholl
ansouhet	ansouezhet
youstek	youst(ek
arbrophesi	profesi
insahet	ensac'ha
gremenneg	gremennek
Chipotal	chipotalchipotat
adroetro	adroetro
evitdoare	evitdoare
pabill	babilh
kiza	kizakizi
diaveasbro	diavaezbro
arvamgoz	mammgozh
rangalon	ranngalon
distrap	distrap
juif	juif
gouez	gouez
flaio	flac'h
dejanal	dejanaldejani
diempennidigez	diempennidigezh
dihlaharet	dic'hlac'hari
tarhereah	tarzherezh
anaoudeien	anaoudeg
Trm	tra
newentis	nevezinti
accouragein	akouraji
pezhiokoad	pezhkoad
lozenni	leozennaleozenni
dichaladur	dichaladur
dic'houtet	dic'houtet
saotaol	savtaol
fid'andero	fidanderv
feurgarga	peurgarga
afalledezo	fellelfelloutfallout
lumier	lumier
Pinnijenner	pinijenner
foran	foran
para	para
guidreal	gwidreal
izellt	izelaat
tenneres	tennerezh
Skoraskola	skora
liened	lienet
Skod	skod
Luguen	leuegen
Aviez	aviez
eunan	eunan
rzamma	resamma
gobius	gobius
arc'hroup	kroup
scrihuet	skrivet
pesked	pesk
chapeledin	chapeledachapeledichapeletat
eurvoudenn	moudenn
valvennigouDoue	malvennDoue
skeduzoc'h	skedus
anorborz	dorborzh
hug	hug
afasd'	afas
cabouillet	kabouilhet
Baragad	baragad
Douar	douarlabour
dourbil	dourbilh
lanchennyen	lachenneg
Diboella	diboelladiboelli
dianav	dianav
debepkourz	koulz
rapint	rapinarapini
foulet	foulet
edamizion	ami
grogioud	krogyod
kendirvi	kenderv
hepgoulennadisken	goulenn
kannadek	kannadeg
eurvammvleizez	bleizez
ribinou	ribin
difforhance	diforc'has
arvudurenn	mudurun
hirisset	hiriset
stadudet	statudastatudi
carnet	karnet
Koublerlevriou	koublerlevrio
sec'hedet	sec'hedet
ephod	efod
nafionquet	fioni
gouremou	gourem
scarh	skarzh
exterior	eksterior
porc'helgouez	porc'hellgouez
ed	devedenn
Autr	aoter
Trguidel	Tregedel
caige	kej
DenaIliz	denaIliz
Tremenlec'h	tremenlec'h
zumudi	sumudi
aziabarz	aziabarzh
agompetaz	kompeta
hint	int
renkennet	renkennet
porsrastel	porzhrastell
Arvouarenvraz	mouarennvras
oberiou	ober
kardelet	kardellet
berboellidigez	berrboellidigezh
hgean	hage
fuzilio	fuzuilha
Rouanezarfoennek	rouanez
truezouz	truez
poangaloun	poangalon
Vieller	vieller
disklapet	distlapadisklapa
Glaoar	glaouaerglaouer
arhoalh	rwalc'h
gwastelled	gwastelli
dichagrin	dichagrin
bromission	promision
Brenniliz	Brenniliz
Daouzekuget	daouzekugent
drougarchas	drougarchas
Japon	Japon
Dider	Dider
Hamsentus	amsentus
Maperdeuio	peurzont
varentenn	wareeuntenn
enemdana	tana
drettat	dretaat
diglosset	digloset
asprena	asprena
fronellou	fronell
Peurglozet	peurglozet
struz	struzh
dourdiluch	dourdiluj
adize	tizha
chakeinchakalchagein	chaokatchaokachaoki
sentuz	sentus
enebiez	enebiezh
klomet	koulmet
Barver	barverbarvier
reclom	reklom
divrit	diverit
instrujein	instruji
rotin	rotin
dibask	dibask
apparance	aparas
Aziarben	azirbenn
Hadgwellaat	adwellaat
Kernevihan	KernevKerne
dalletoc'h	dalet
aboell	aboell
beizik	beizik
siellet	siellasielli
dizonjer	dizojer
astommet	astommet
Hanaedigehvad	anavedigezh
tiezhnveg	tihavek
Kaladuria	kaladuria
talvouduz	talvoudus
darempredet	darempredet
skanvadurezou	skavadurezh
mouchet	mouched
bridouar	pridouar
pillennek	pilhenneg
plunnouearc'h	pluerc'h
bourlikhabourlok	berlikhaberlok
dic'hourda	dic'hourda
digalon	digalon
vezia	bezia
rizeennomae	rizennvaen
I	dis
arc'houarnamant	gouarnamant
torchennet	torchennet
onix	oniks
Clasc	klask
frugpenn	frugpenn
eihdad	eizhteziad
D'arpet	pet
ennhebezpikol	pezhpikol
fumi	fumafumifumal
prestou	prest
'nevesk	emesk
renket	renket
spurmantein	spurmanti
hantrr	hantereur
Quifniantesset	kevniantez
spurget	spurjaspurji
bremaik	bremaik
goalllez	gwallael
balustr	balustr
nedevezmeizeuz	meizmez
amzerdiveza	amzer
vovo	vovo
Keur	keur
oberklask	klask
Blasfematored	blasfematour
troc'hercoat	troc'herkoad
eurbalustrou	balustr
chalquet	chalket
rebutet	reputareputi
divouton	divounton
skeduz	skedus
dibratik	dibratik
soignus	sognus
goustet	gousti
dardur	duardur
bastet	bastet
Baran	baraenn
peurachu	peurechu
setuaze	setu
finvadenn	fivadenn
Normandi	Normandi
alert	alert
autramant	otramant
digoch	digoch
entanet	entanet
fermdigor	digor
dijadenn	dichadenn
kompagnunez	kompagnunezh
enemrei	rei
dissimur	disimur
goalhent	gwallhent
tafia	tafia
azerlagad	aserrlagad
ovoenni	gouenni
Adro	adro
dic'hlac'haret	dic'hlac'hari
roufennet	roufennet
Caozeaden	kaozeadenn
Azkavetoun	askavet
mousqedryen	mouskeder
viquelage	vikelajvikeliaj
rouignek	rognek
flip	flip
argalite	kalite
Izlat	izelaat
fik	fic'h
filosofe	filozof
dijell	dijell
aziboello	diboelladiboelli
humnaturrat	naturaat
dleour	dleour
enhefart	part
venadurez	benadurezh
imbecil	imbesil
gouiliadeu	goueliad
koadelv	koadelv
distrobel	distrobell
choura	chourachouri
dizabuzet	dizabuzet
pinijen	pinijenn
tr	tra
mandragore	mandragor
Cozle	kole
gaozeadenn	kaozeadenn
hirvelet	hirwelout
keuneudtan	keuneudtan
SantGoustan	SantGoustan
glizen	glizhenngwlizhenn
digredoni	digredoni
spernegou	sperneg
meudikaz	meudika
kigouarnour	gouarner
transportus	trasportus
Jermen	Jermen
abebmode	abepmod
vis	bis
orglzeu	orglez
devor	devor
dis	dis
houlius	houlius
suilhet	suilhasuilhi
frippon	fripon
Foeterezikarbelek	foeterezigarbeleg
Semeill	semeilh
abegeit	pegeit
c'hoariel	c'hoariell
Vodiliz	Bodiliz
parft	steredparfet
stoubenneg	stoubennek
varzoug	warzoug
flambeu	flambev
visericord	mizerikord
Lentuz	lentus
dizez	disez
divraza	divrazadivrazi
delerion	dleour
bugadet	bugadet
ingroez	engroez
brec'hhabrec'h	brec'hhabrec'h
Lauranz	Laoras
e	hent
ainou	aeno
douarran	douarran
caniet	kaniet
aillounat	hailhonihailhonat
azistrone	distrona
gwezbanan	gwezbanan
bebeild'erh	abepeild'arwezh
deveden	devedenn
deveden	devedenn
Tirren'	tirenni
Toupina	toupina
digoumpagnoun	digompagnun
bobardiogoz	bombardiougozh
chas	chas
zinac'h	dinac'hidinac'hadinac'h
azindantenn	azindantenn
norralhuourrerion	doralc'hwezer
Trest	trest
bac'hateet	bazhataet
Madianited	Madianit
estouen	stouistouastouetstouo
goumpaignunezou	kompagnunezh
Vikeliaj	vikelajvikeliaj
kaliriou	kalir
bouillasou	bouilhas
danan	tana
chafodou	chafod
zourbilh	sourbilh
gevredihuel	gevreduhel
Avoultrer	avoultreravoultrier
houbet	houbet
ahoulen	ahoulenn
tanflammet	tanflammet
adreushagahet	adreuzhagahed
hunan	eunan
baleant	baleant
qaouennesed	kaouennez
aiouank	ayaouank
arendevhat	diwezhad
louan	louan
largantus	largentezus
blean	plaen
kared	karet
fraudage	flodaj
Barabrased	barabrazed
Poulldoura	poulldoura
accouragein	akouraji
dic'hrasiet	dic'hrasiet
skoill	skoilh
divoc'h	boc'h
mizerdedistac'h	mizerdedistac'h
amzer	amzer
enemskuiza	skuizha
Sans	sas
nec'het	nec'het
lorb	lorb
tawed	tavet
couskhean	kouskehan
Vande	Vande
Douarmelen	douarmelen
bromessaou	promesa
dilladguele	dilhadgwele
kollet	koll
Dispara	disparadisparidisparat
isitet	isita
lorberion	lorber
deisiadet	deiziadet
filozofi	filozofi
eurbarti	parti
dadabat	tadabad
Comps	kompez
disc'hlac'har	disc'hlac'har
zaltin	saltin
ac'hruzuil	ac'hruzuilh
o	saotr
kuchennek	kuchennek
berveled	berrwelet
toutek	toutek
kikastenn	astenn
melandourn	melldorn
arrestance	arestas
tuemzer	tommzer
barrbrandon	barrbrandon
chilp	chilp
genedet	kenedet
distrilla	distrilha
merchad	merkad
lentidigez	lentidigezh
Treiliououarn	treilhhouarn
kraperigargwez	kraperiggwezkraperigargwez
greateundomaden	tommadenn
Moumoun	moumoun
guerc'hder	gwerc'hder
perpetuel	perpetuel
Dieubi	dieubi
ahdet	ahedet
renevezi	renevezi
ed	galez
ziskianted	diskianted
marc'hbleyn	blein
guentachou	gwentajo
gedikou	gedig
stalamardet	stalabardetstalamardet
kousket	kousketkouski
diotiez	diotiezh
n'emrodelenni	rodellenni
kolldaskiantvat	skiantvat
Sac'het	sac'het
Kofilis	kofilis
ch	se
enkrezi	enkrezi
dirankont	dirankontr
melenog	melenog
enemgomporti	komporti
azwelout	azgweloutazgwelet
pimant	pimant
Ind	int
instrugein	instruji
rebech	rebech
douaren	douarenn
zizalla	dizalla
digoustianz	digoustias
Gweachavez	gwezhavegwezhavez
diaboissance	diobeisas
devotius	devotius
chomabla	ablas
bifo	pif
p	pe
fimel	fimel
lorvez	lorwez
humzivlammein	divlamadivlami
beulim	binim
dirann	dirann
difeiz	difeiz
takezen	takezenn
dougunda	dougeeun
serruz	serrus
zrougentent	drougintent
reposvan	repozvan
gollont	koll
Kabestr	kabestr
efeeruz	eferus
pennkenta	pennkenta
tiskornadi	diskornadi
katekouyek	katekouilheg
fondzon	fondezonfondezion
grizienngrizion	griziengrizion
ouaskella	gwaskella
muiouzvui	muiouzhmui
ahoustvad	ac'houstvat
gros	gros
Divarc'hagnet	divac'hagna
divroedigueah	divroedigezh
bagatellage	bagatellaj
pervisca	peurwiska
rei	lufr
Sul	seul
Klaoustreer	klaoustreer
chkrivanil	skrivagnol
enf	e
toezhatoez	touezhatouez
nevezflamm	nevezflamm
feurlok	prolog
goasketoc'h	gwasket
adaol	adaol
beguelyyen	begelieg
enemdiambarassi	diambarasi
Eskeud	eskeud
rejanti	rejanti
barvok	barveg
nebhedetquet	pec'hedi
Bou	bo
livaden	livadenn
pi	pi
minorik	minor
torr	torr
leuemor	leuemor
Puilla	puilha
gwikefregwikhefre	gwikefre
gouez	gouez
Divroidi	divroaddivroiad
sinvez	sinvezh
reseourien	resever
Pingwz	pingouez
digreski	digreski
arwenik	gwennig
Hospitallerien	ospitaler
benadurez	benadurezh
rapine	rapin
diboumbel	dibombell
Tourtal	tourtaltourta
inclinationou	inklinasion
divodesti	divodesti
gwikefregwikhefre	gwikefre
bisou	bis
grizinkalgerzignkhal	grizinkal
vunsat	musat
devotius	devotius
dihouyc	diouiziek
schuh	skuizh
penneuquetan	pennkenta
eurzelladruez	truez
Abennneuze	abennneuze
fausoni	faosoni
baraouz	para
culatour	kulator
abldebl	abelldabell
diveiadagorf	divec'hiadivec'hadivec'hi
rozelloforn	rozellforn
sivellenna	sivellenna
aginou	eno
Nearvarket	arvari
zangr	dajer
aviade	gwiadi
luniou	Lun
Diranned	dirannet
ed	megel
ciquet	siket
disaezit	disaez
merzerentiou	merzherinti
broudryen	broder
taolru	ru
lorvez	lorwez
doueserez	touezerezhtouezierezh
furol	furol
avozadou	avozado
propic	propik
abardaveznoz	abardaevezhnoz
ioulc'ha	yourc'ha
Enemzic'hoantaad	dic'hoantaat
honbede	bede
badinach	badinaj
flatrerezed	flatrerez
Izella	izel
ingaillerion	ingailher
izelaat	izelaat
louzaouat	louzaouad
diboaniet	diboaniet
peurliesa	peurliesa
enemzantelaat	santelaat
euzi	euzhi
keeluz	kehelus
avent	avent
parveni	parveni
begulenod	bugulanaod
divodeste	divodest
c'hoaritoulpouliq	poullig
falvrud	fallvrud
azrannou	azrann
ebleo	eblev
zec'hor	sec'hor
foug	foug
henmahen	hennmahenn
randonen	randonenn
Forester	forester
countantamachou	kontantamant
Arvlaz	blaz
uzached	uzajet
skedus	skedus
guerh	gwerc'h
Trouskenna	trouskenna
grimaseryen	grimaser
anndaperien	taper
undinrdt	tenerded
enemdourta	tourtaltourta
Herri	Herri
glozard	glozard
dervennou	dervenn
herder	herrder
doare	ebat
noazpik	noazhpik
damzec'h	damsec'h
gonvor	govor
froderez	floderezh
avoultri	avoultri
arc'hirritan	karrtan
sammusoc'h	sammus
bistach	pistach
diwinkelat	diwinkelat
mouzik	mouzhig
voardoan	wardoan
goalisprit	gwallisprid
rizennouvoguer	rizennvoger
Tourqed	tourked
tillach	tilhaj
pouldroennou	poulldroenn
tetanos	tetanoz
dinobli	dinobli
azic'haloup	dic'haloupat
trousqennou	trouskenn
lurius	luzius
aboc	abok
scanvat	skavaat
consolusset	kosolus
Avoultrryen	avoultreravoultrier
uz	uz
ieuet	yeu
koumpez	kompez
chiquet	chiket
amzer	amzer
boleet	boleaboleatbolei
Chipotal	chipotalchipotat
forban	forbann
Koantoc'hzo	koant
menthe	mant
ober	furch
Houp	houp
diliamm	diliamm
labousikhorZalver	labousighorSalver
uzulierezo	uzurerezh
urhachemar	kasmare
enhec'herc'hen	ekerc'henn
henthouarn	henthouarn
afars	afars
famina	famina
lastreg	lustrugenn
warc'horre	warc'horre
alouberez	alouberezh
abistigas	pistiga
distagerien	distager
ispicer	ispiser
koreo	korreenn
gwel	gwall
tremeniat	tremeniad
voarem	gwaremm
Kernu	KernevKerne
keuneudet	keuneudet
rimadelled	rimadellet
klah	klask
dourbarr	dourbarr
cavlet	kavellet
ginaouegioc'h	genaouegigenaouegal
lastrussoc'h	lastrus
baliSJakes	Jakez
flipad	flipaflipatflipi
Zouarneneziz	Douarneneziz
horrerus	orrolus
redia	redia
arvaleanted	baleant
liorzadou	liorzhad
panerhada	panerhada
Nil	Nil
laervar	laer
edrohagezidro	didrei
veanre	anat
Goeliadgoueliad	goueliad
brizaotrouien	brizhaotrou
noazoutouzomp	noazoutnoazinoaz
touer	touer
sex	seks
diskorpul	diskorpul
Eurgarkleiz	kerc'heiz
Kaskalat	kaskalat
filosofed	filozof
zil	sil
Sisakre	sisakre
diroll	diroll
dambonr	damboner
caractr	karakter
arc'halvar	kalvar
fidandoustac'h	fidamdoustac'h
splannder	splannder
porzarzilvidigez	silvidigezh
evembzec	vembzec
guiaderez	gwiaderez
bayounettez	baionetez
disinoui	dizenoei
Sigougn	sigognsigon
rebechet	rebechrebechirebechat
morgizhier	morgazh
parkeerleton	parkleton
vermisel	vermisel
aissite	isita
palefarzet	palefarzhet
daoubleget	daoubleget
Chetuperac	setu
eneminformi	informi
skora	skora
gorreKerne	GorreKernev
hedamzer	hedamzer
poullomor	poullmor
dic'hoero	dic'hwerv
argaptived	kaptiv
lesvarn	lezvarn
minkrapoas	maenkrampouezh
glaoeier	glav
spled	spled
Goalldroet	gwalldroet
tor	tor
Thereza	Tereza
vonjourein	bojouri
bidac'h	bidoc'h
stouet	stouistouastouetstouo
blean	plaen
troubl	troubl
skolieta	skoliataskolata
enemdizec'hedin	disec'hedi
isfond	isfont
tommhatomm	tommhatomm
riblennou	riblenn
autramanteguet	otramant
urhourem	gourem
Killeri	kilheri
neuen	neuzenn
arneuog	arnevek
plafet	plavet
hoc'hunan	hoc'hunan
difranjellat	difrajellat
trihateri	trihanteri
Magnez	magnez
mavezokoanietd'in	koaniakoagnikoana
Franseza	Fraseza
lsa	laesha
dishenvelded	dishevelded
egzesour	egzesour
roustadou	roustad
Tadanorgouilhagargaou	tadanorgouilhhagargaou
karoulle	karoulle
Poullet	poullet
azal	azal
fled	fled
Noal	NoalPondivi
azizantellaz	dizantella
tanfouestras	tanfoestra
agordigelle	kordigella
eziforhas	diforc'hidiforc'hadiforc'h
sakramantanaoter	aoter
pounsoun	poson
oblijet	oblijet
sklasan	sklasasklasi
reconciliation	rekosiliasion
pevarc'hant	pevarc'hant
diali	diali
c'horre	gorre
c'hodisal	godisalgodisa
andaolsantel	taolsantel
torgennek	torgennek
vikelJesusChrist	vikelJezuzKrist
dasado	tasad
talmad	talmad
regnet	regnet
marvaill	marvailh
negizoket	kizakizi
dirann	dirann
iaouankizi	yaouankizi
Entronozvintin	entronoz
Aita	'ta
rederienvor	redermor
milinwenteres	milinwenterez
abeurglask	peurglask
bistouff	boustouv
arvenac'hbeleien	manac'hbeleg
aziabarhd	aziabarzh
Triakler	triakler
Abazeu	abazo
hijendoa	hij
hadon	andon
Krapinella	krapinella
spereddebret	debret
Butunfri	butunfri
peurvaro	peurvarv
eurganen	kanenn
c'hloriuzded	gloriusted
azohinou	eno
arc'hilcrog	kilkrog
arvranken	brankenn
miraculus	mirakulus
dic'hougadenn	dic'houzougadenn
gest	gwest
ramezeneignramzeneign	ranezenni
eurc'heneskob	keneskob
Berric	Berrig
Plianiz	Plianiz
dolbac	talbaktalbok
abln	plaen
dizaoni	dizaoni
Enhofard	part
remarquable	remarkapl
dic'hiz	dic'hiz
faussonie	faosoni
kusmudika	kuzhmuzika
anemised	anemiz
fichelladou	fichellad
reveursi	reveulzi
avaredavare	avaredavare
anerzkaloun	anerzhkalon
seblandiq	seblant
arac	arak
hentlouarn	hentlouarn
goalloberou	gwallober
avriadkorf	avriadkorf
leazrez	laezherezh
wargoll	koll
askiantvad	skiantvat
chomabla	ablas
bremaik	bremaik
azindanguz	azindanguzh
dissorb	disorb
gouander	gwander
coublad	koublad
jentillt	jentilaat
sciel	siell
treuzi	treuzitreuza
tignol	tignol
c'hoelMikeal	Mikael
dizesk	dizesk
eihvet	eizhved
dizalled	dizalla
aluche	lucha
absint	absint
dourbeuz	beuz
domajou	domaj
doubleviou	doublevio
tregondad	tregontad
mekanik	mekanik
rakrak	rak
Piou	piou
wawawa	way
difraostet	difraostet
ingroez	engroez
faceaface	fashafas
Tehuignoud'ein	gwignalgwigni
dibled	dibled
sklabezet	stlabezetsklabezet
kennadanfinfoeltro	tanfinfoeltra
makoahe	koazhakoazhi
riscusbras	riskus
squdet	skeudi
broffani	profani
commotoc'h	komod
cantoul	kantol
Doucrus	douserus
peskedkrogennek	peskkrogennek
Qedez	kedez
gairr	keur
Pillerezheguenou	pilerezhegeno
chif	chif
gramherianed	grameliangramerian
Skoanenn	skoanennlaezh
dizurz	dizurzh
fringolou	fringol
aziarscan	azirskav
digoumoul	digoumoul
Penngez	pennegez
kovellek	kofellek
hordosset	hordoset
sunergwer	sunergwer
menirein	menieri
gourvezet	gourvezet
afond	afont
berteikberteiktout	berteik
huguenaud	hugunot
'rC'horporal	korporal
gwano	gwano
Paltokennad	paltokennad
lpre	lepr
pennbah	pennbazh
teurc'hoezet	torc'hwezet
troadoc'htroadganthi	troadouzhtroad
revwet	revevet
divourabl	divourrapl
meillmein	meilhmaen
enemnec'hi	nec'hi
bagoupesketa	bagpesketa
laieuaj	leuoeaj
direligion	direlijion
entanet	entanet
perhuhussoh	pervezhus
soublien	soublien
tignolik	tignol
laour	laiour
dichanz	dichas
Strak	strak
melenok	melenog
fonhour	foevour
ollfur	hollfur
bagueryen	bageer
erder	herrder
caoutholank	lank
Bourbounenn	bourbonenn
oracl	orakl
meadreuzaz	treuzitreuza
Pantei	pantei
pignoun	pignon
aaspreno	asprena
afdnoz	afednoz
skinsal	skisal
dianaves	dianavez
Adro	adro
reoliet	reoliet
eurveachanamzer	amzer
scrijou	skrid
ioufask	YaouBaskYaouFask
urc'hran	kran
enhegerc'hen	ekerc'henn
crouis	krouis
harz	harzh
heheun	eunan
abaster	habaskter
skurpul	skorpul
iec'hedigez	yec'hedigezh
riou	riv
noazoutd'	noazoutnoazinoaz
varnedtol	waranhedtaol
arguistinecqqestenecq	kistineg
chutellat	chutellat
dizispign	dizispign
nebaoun	nebaon
koatkreo	koadkrao
Polozen	polosenn
houst	goust
zet	aezet
dourasen	dourasennek
gouarnamant	gouarnamant
Grisienrz	gwriziennruz
newentiz	nevezinti
derderann	trederenn
kombot	kombod
Koanhoc'ha	koanoc'ha
zleour	dleour
eurvorc'haden	bourc'hadenn
pallennouqesecq	pallennmarc'h
sioulamant	sioulamant
discampet	diskampa
greunadour	greunadergreunadour
begouDoar	begdouar
Liket	liket
breizad	breizhat
leski	laezhki
las	las
hihasshhent	hent
humlotias	lotia
arvoralen	moralenn
fulec'hen	fulac'henn
pipon	pipon
aboell	aboell
Arab	Arab
adaol	adaol
zulc'houel	Sulouel
moust	moust
meudet	meudameudi
filosofi	filozofi
falskredennou	falskredenn
habiltt	abilded
petore	petare
dreali	ali
porteal	portezaportezalportezat
Bater	pater
coublad	koublad
Yvonig	Ivon
arc'houre	arc'houere
avrhad	avrec'had
diluiet	diluziet
Bastien	Bastian
rokeden	rokedenn
goallzamm	gwallsamma
loaioraned	loaraned
pilglao	pilglav
klasktrabasouz	trabas
paloueret	palouerapalouerat
difougue	difouge
argaptivet	kaptiv
azennicgueu	azenig
arbres	pres
o	kad
Aino	eno
difonded	difesonded
abergaledas	peurgaledi
aziwarskan	aziwarskav
adorerion	adorer
boubou	boubou
placet	plaset
gouzilh	gouzer
zfoyan	zefoyan
arbrosesion	prosesion
dizomagein	dizomaji
harpein	harpaharpi
zourbeo	dourbev
scridou	skrid
c'hoariellou	c'hoariell
thologi	toloji
diouc	diouiziek
roudou	roud
SantGultasaRheuys	SantGweltazaRewis
sklent	sklent
dilorhas	dilorc'ha
sul	seul
deledan	delledan
goueziad	goueziad
diousklufet	divsklufet
divlas	divlaz
Miz	miz
eostig	eostig
wiski	wiski
barvier	barverbarvier
hec'harante	karantez
badouell	baduell
lipet	lipet
Vovoau	vovo
pennoukenta	pennkenta
labenna	labenna
oulch	ouelch
pedu	pedu
rescondable	respontapl
hadwelet	adwelout
Vac'harantez	karantez
foennen	foennenn
diabeg	diabeg
didruhdigueah	didruedigezh
mantal	mantal
nsiket	sia
trist	trist
goaremmou	gwaremm
brizdiod	brizhdiot
ne'kuir	nekwir
brochennet	brochennet
II	e
neuet	neuziet
doulltalar	toulltalar
jambezenn	jamezenn
disouil	disouilh
riou	riv
ahinihue	ahiziv
noble	noble
bleudran	bleudran
gwaspell	gwaspell
lousoni	lousoni
melchen	melchon
Pasteei	pasteza
dic'hlac'haraz	dic'hlac'hari
muiedigeah	muiedigezh
eostik	eostig
primhaprim	primhaprim
zerhias	aziriaz
strngouillomp	strangouilha
amzevod	amzevot
dero	derv
nekuir	nekwir
alia	aliaalii
Hanokaer	anvkaer
idenn	edenn
grizilloned	brizilhonet
skanvadurez	skavadurezh
guetezou	get
agetarah	agentarazh
beizik	beizik
lambrissadur	lambrisadur
philozophi	filozofi
muiouzvui	muiouzhmui
consortizou	konsortiz
digoustians	digoustias
avieler	avieler
arganienn	kanienn
meanbenerez	maenbenerezh
dic'hlan	dic'hlan
stankennou	stankenn
idolaerez	idolerezh
hadskoaia	adskoazia
dic'hout	dic'hout
dizunanet	dizunanet
obergoapoc'h	goap
Abadorenn	abadorenn
guedouryen	gedour
goezaerverrentez	berrentez
anderzienkart	terzhienngart
seurezedkonvers	kovers
tazou	tas
diouech	diouch
trapout	trapout
dic'hradet	dic'hradet
bouilla	bouilhas
substantein	substanti
peurglasq	peurglask
amparval	amparfal
Bevechma	bewechbewezh
adrochouk	adrochouk
dizarle	dizarle
ispridet	ispridet
Hagn	hage
giniterfgompes	kompez
rec'hi	rec'hi
drompladurez	trompladurezh
spouronnuz	spouronus
mardandoustik	mardandoustik
andon	andon
forbanat	forbannat
chapelarvadisiant	chapelvadez
'nonchakat	chaokatchaokachaoki
vagajenna	magazenna
spinac'het	spinac'haspinac'hi
rimaderez	rimaderezh
nshadeiz	nozhadeiz
goaf	goaf
arc'hokombr	kokombr
Trouc'herbuzug	troc'herbuzhug
tallabour	taollabour
ziacouragein	diakouraji
farserez	farserezh
menezis	meneziadmenezad
enemadwelat	adwelout
Coataat	koataat
fic'hellerez	fic'hellerezh
loensamm	loensamm
farouel	farouell
ahirded	ahirded
cuylatouryen	kulator
peurest	peurrest
dic'hloar	dic'hloar
kollou	koll
vintinvez	mintinvezh
Eraz	razi
dourbeuz	beuz
harpaouc'h	harpaharpi
hoarnation	gouarnasion
selleryon	seller
dreicheu	tres
stakprenn	stagprenn
god	kod
rebech	rebech
Kenclo	kenklav
eurgompord	komport
discrognet	diskrognet
troiokamm	trogamm
alumetezchimic	chimik
flastret	flastret
eskana	skavaat
corred	korr
goroadennou	goroadenn
noumesq	emesk
diodet	diodet
hopetdoan	doan
Moumou	moumoun
startaat	startaat
brabanser	brabaser
reneuamant	renevezamant
Everz	hewerzh
domach	domaj
Alc'houezet	alc'hwezet
peurlaza	peurlazha
demeus	dimeus
erruet	erruet
beobuez	bevbuhez
eilbeved	eilbeva
Lanevez	Lannevez
pladennec	pladennek
ibila	ibila
polisenni	polisenni
ivlneg	eoulennek
bekfuzil	begfuzuilh
attacion	atasion
gouez	gouez
pilgos	piltos
adlevezo	dlevezout
flat	flatrerezh
ranngalon	ranngalon
Spalourbras	sparfellvras
sentuz	sentus
precho	pres
risk	risk
sermant	sermant
divagannet	difaganet
treujou	treuzo
rec'ha	rec'hi
abostoler	abostoler
melfed	melc'hwed
Setuarpeza	setu
lostarbleiz	lostarbleiz
comanadeost	koumananteost
argastidigez	kastidigezh
trabell	trabell
stalerez	stalerezh
Karoulle	karoulle
ac'hrac'hel	awrac'hell
dic'hourda	dic'hourda
vrea	brae
heuza	heuza
nouzpegeit	nouspegeit
diboell	diboell
kollout	koll
lenn	lenn
aridennet	aridennet
izilied	iziliet
siet	siet
zisfe	disfeiz
Moushwarzin	mousc'hoarzhin
reposuan	repozvan
dremedal	dremedal
andremenidi	tremeniad
distanshadistans	distashadistas
pengeneign	pengenni
diskuil	diskuilh
splez	splez
goantiz	koantiz
Dirabansi	dirabasi
eurvesaeres	maesaerez
piladdour	piladdour
azerhlu	aziwarlaez
skeduz	skedus
egras	egras
disvrot	disvroet
fidoustic	fidoustik
frhettoh	frouezhet
lonkereh	lonkerezh
bikiliat	pikailhat
terinier	terinier
etablisset	etablisa
dishavaledigueah	dishavaledigezh
dourmelis	dourmelis
hentr	entre
tamallou	tamall
intanhuigeah	intavegezh
chipotal	chipotalchipotat
annunan	anunan
prenvetguen	prevgwenn
karg	karg
yodtaryen	yotaer
c'houit	c'hwit
Peuk	peuk
dournerez	dornerez
tammtamm	tamtam
itic	itik
pennbonnet	pennbouzellet
passabl	pasabl
jujet	juji
gwaremm	gwaremm
ranez	ranez
brellentez	brellentez
rabotet	rabotet
disc'hlac'har	disglac'har
Urgribieres	kribierez
marc'hkavo	marc'hkav(o)
anhentse	hent
argaouleden	kaouledenn
arbrosesion	prosesion
Diginklet	diginklet
peurest	peurrest
punet	punet
arFourn	Forn
dornerez	dornerez
urgrousten	kroustenn
fanfarluchou	fafarlucho
arvoulge	rvoulj
dourbil	dourbilh
anderchenburbuennoc	terzhiennvurbuennek
dibourvance	dibourvezas
Legestr	legestr
gripissa	kripisa
dardec	dardek
saoz	saoz
despezus	despezhus
war	foran
divazoulennet	divazhoulennet
enderdran	trederenn
ed	prei
ezigasshed	degasdegasi
opiusa	opiusa
chetui	setu
humstouyas	stouistouastouetstouo
rizennou	rizenn
breintuf	brein
lipet	lipet
zivadelez	divadelezh
zizorc'heni	disorc'henni
zispag	dispak
sqilfadennou	skilfadenn
abaouekeitamzer	amzer
ambarassus	ambarasus
ruanies	rouanez
Hanteraff	hanterahanteri
carabinennou	karabinenn
eltrisa	eltrisa
strepet	strapastrapat
emmerret	emeret
anouezen	havouezenn
ekeitamzerma	ekeitamzerma
MaEghinat	eginad
bistiga	pistiga
taltous	tartouz
quemeretusurerez	uzurerezh
azournad	azornad(o)
galetten	galetenn
sauvet	saovi
Chifal	chifachifalchifi
meinadurez	meinadurezh
allumeteschimig	chimik
ollvadelez	hollvadelezh
lutina	lutina
glosus	gloazus
Bre	bre
providans	providas
humabuset	abuziabuz
eurgur	kur
barbouill	barbouilh
Hirlachenn	hirlachenn
Elamitet	Elamit
nigoudouill	nigoudouilh
diben	dibenn
'instrugein	instruji
Gwazienn	gwazhienn
toked	toked
dibunerez	dibunerez
meritein	meritoutmeritameriti
beziad	beziad
ravolt	ravolt
heunanpenn	eunan
leze	leze
digrogennet	digrogennet
opium	opiom
lonkerez	lonkerezh
hevarc'hlimon	marc'hlimon
provei	profaprofiprof
meanoaled	maenoaled
foenchen	poechenn
c'horoet	goroet
mammoukoz	mammgozh
azanvez	azanvez
chitryen	chinter
dimez	dimez
urzet	urzhet
kegit	kegid
pourceln	pourselen
humzismantou	dismantradismantridismantr
difouge	difouge
zahouarn	saehouarn
enembistiga	pistiga
paterennet	paterennet
morian	morian
douj	douj
hegach	hegaj
agetama	agenta
b	b
'metrak	merak
farserez	farserezh
testeni	falstesteni
eziroulr	dirouli
disanve	dizanavez
bura	pura
Danjer	dajer
rukunuz	rukunus
noumesk	emesk
voerebkoz	moerebkozh
ribisatkrabisat	kribisat
pozn	pozenn
Strobella	strobella
qevendirvy	kevenderv
Toulbennik	toullbennig
Trechonei	trichina
baotdistro	paotrdistro
gobiuz	gobius
gouaad	goavad
nozpad	nozpad
kelzen	kalzenn
dilovret	dilovri
vedita	medita
disenoret	dizenoret
digoust	digoust
pres	pres
reizvuele	reizhwele
ruzven	ruzwenn
didach	didach
vvin	kraoennvevin
necetuqet	setu
nehuhan	nevezhav
azvent	Azvent
usuilleres	uzurerezh
stolu	stol
gwezzedra	gwezsedra
anec'he	nec'hi
damholl	damholl
beurzibenna	peurzibenna
disclration	disklrasion
cava	kava
plantenne	plantenni
eulfennoutan	elfenndan
astraclo	strakla
defian	difias
didach	didach
nvsq	emesk
jacobitd	jakobit
machepain	masapan
eurgotelbif	kontellbif
urhoarem	gwaremm
arc'holera	kolera
bourc'hadenou	bourc'hadenn
enemzisa	disa
adlevezo	dlevezout
divelgret	divergladivergli
Japon	Japon
derveq	dervek
rezmad	reizh
gon	gon
droukprezegerez	droukprezegerezh
liboustren	liboustenn
evelennik	evelhennik
spisonni	spisoni
aveet	aveiaven
harpein	harpaharpi
d'hokaout	dagaout
aabadennou	aabadenno
Nasket	nasket
hunan	eunan
diz	dis
soublien	soublien
accompagnunect	akompagnunekaat
diblas	diblas
voaderessa	gwaderesa
sex	seks
digor	digor
caritellou	karitell
alarc'h	alarc'h
hachu	hach
difeiz	difeiz
ariolen	riolenn
Magazenna	magazenna
breg	preg
Pikerigarguez	pikerigargwez
Monica	Monika
buguelnos	bugelnozbugulnoz
lachentes	lachentez
Arc'hartermestr	kartermestr
finvaden	fivadenn
displica	displika
azespez	despezhi
clicqedou	kliked
youst	youst(ek
arvestrezkear	mestrezkr
diamodein	diamoedi
korzennek	korzennek
pnfond	pennfont
peurdistruja	peurzistruja
fourmus	fromus
kovellek	kofelleg
peurvaro	peurvarv
groahlann	gwrac'hlann
entez	er
acours	akours
zaoudec	daoudek
gant	chal
largantus	largentezus
enembourvuet	pourvui
azoaevezwar	aevezh
zac'helek	sac'hellek
liammet	liammet
grasedigueah	krasedigezh
zalmatenein	salamantenni
perdrachat	peurdrachat
c'hoarezedmager	c'hoarvager
peurdrec'het	peurdrec'hi
abad	abad
Coateat	koataet
piltosek	piltosek
melc'hod	melc'hwed
gaudissal	godisalgodisa
steredenni	steredennisteredenna
raou	rav
dispounta	dispont
ribin	ribin
tribu	tribu
jamezen	jamezenn
didatek	dizantek
ptelek	peteleg
chass	chas
ostant	ostant
spouronus	spouronus
voar	rei
damholl	damholl
mut	mut
evezdet	evezhded
p	pe
ezihanadas	dizanadi
fabourzyo	fabourzh
peurnetaat	peurnaetaat
ezetamant	aezetamant
boanspered	poanspered
dilhadet	dilhadet
mervel	aglavwele
arSperedSantel	SperedSantel
bonnfamm	boufam
Ez	euzh
endalc'het	enderc'hel
bageer	bageer
amzernehu	amzernevez
bodennet	bodennet
dioc'h	diamezek
exemplus	egzamplus
ingros	engroez
recevour	resever
heunan	eunan
qeuzeudiqt	keuzidikaet
ezetat	aezetaat
mezepet	mezepet
zularPuslard	SularPeuzlard
Glaouaerglaouer	glaouaerglaouer
estouent	stouistouastouetstouo
roustadbac'hadou	roustad
gournei	gournatgourni
raquit	rakuit
Trabiden	trabidenn
gnanus	jenasus
ran	ran
druillo	truilha
kammed	kammed
blondin	blondin
zigasontdazonjda	degasdegasi
dal	hentdall
presteu	prest
Lousaounnstauter	staoter
maneur	maneur
brein	brein
Fic'hellat	fic'hellat
veleneq	evelhennik
grouation	krouasion
pezic	pezhig
hainad	anat
gaerbez	kaerbezh
exemplus	egzamplus
Eurbarti	parti
ziam	diam
kozamzer	amzer
dumia	tumia
moret	moret
Sutella	sutellasutellat
kaleteit	kaletaet
doubled	doubledie
diboumbel	dibombell
tenzorier	tezoriertezorer
lorchennek	lorchennek
bailhadou	bailhad
lounkerez	lonkerezh
Aslavaret	azlavarout
ouilereah	gouelerezh
sigur	esigur
Lizerennou	lizherenn
Kofignon	kofignon
von	von
Aino	eno
miraculus	mirakulus
antiphonenn	antifonenn
dourtan	dourtan
goalguemret	gwallgemeret
Roans	rouanez
jacqezen	jakezenn
digenter	digenter
chagrinet	chagrinet
varhedtost	warhedtost
bgad	begad
Setuama	setu
Ambros	Ambroaz
dic'hloar	dic'hloar
suitteu	suit
gwelead	gwelead
endinrdt	tenerded
goudouerou	goudor
Grefad	grefad
divezusa	divezhus
betechen	betekhenn
spont	spont
houhunan	hoc'hunan
arodel	rodell
birvik	birvik
c'hinaougui	genaouegigenaouegal
eurganen	kanenn
hantis	hantiz
ebad	ebat
maltred	mart
guiw	gwiv
hazober	azober
beveichma	bewechbewezh
ruellat	ruellat
morsyouprenn	morzprenn
minor	minor
merherhelluru	Merc'her
rangennet	rajennet
disalbad	dizalbad
scoazellouplec	skoazellbleg
dsavoein	dizavoui
ebateogantho	ebat
Urbater	pater
eursizunvezioubennag	sizhunvezh
tanflammet	tanflammet
velkoniet	melkoniet
caijaj	kejaj
erwen	dervenn
d'nou	eno
feal	feal
broiouhuel	broiouhel
glaw	glav
ederm	termaltermat
vantredistag	vantredistag
mahet	mac'het
para	para
chentilaet	jentilaat
Catalog	katalog
crouiset	krouizet
I	lug
rozellopillig	rozellbillig
erder	herrder
abellamzer	abellamzer
rebreicheu	rebech
pennlzen	pennlezenn
estonaploc'h	estonapl
taulsel	taolsell
MariFranseza	Fraseza
Asederre	sederaat
divec'hia	divec'hiadivec'hadivec'hi
erhogui	koegi
lec'hiennou	lec'hienn
tabernacleu	tabernakl
anans	asas
feilhennoc	feilhennek
droukkelou	droukkelo
o	bolad
digompez	digompez
Gwic'hal	gwic'hal
Kozrejis	rejis
unvan	unvan
cohle	kole
guelbrun	gellbrun
askiltre	skiltra
mega	mega
divoutou	divoto
neketebad	ebat
skeduz	skedus
dic'houtas	dic'houti
tric'hant	tric'hant
arvambarrez	mammbarrez
dirglet	direglet
kannennad	kantennat
OKroaz	kroaz
dishalana	dizanala
semplet	semplet
Glormeneh	kloervenec'h
Gouigour	gwigour
estonapl	estonapl
Londrez	Londrez
fablennou	fablenn
arc'heskopti	arc'heskopti
andromplson	tromplezon
gantroudou	roud
diarvar	diarvar
zrabel	trabell
ptreure	petore
difazius	difazius
poanSantCadou	poansantKadou
kiljacha	kilsacha
Iterdia	interdia
amguzet	amguzhet
Daouzekved	daouzekvet
diroll	diroll
accompagnunecaat	akompagnunekaat
dizoan	dizoan
enabascder	habaskter
deuguent	daouugent
dianzavou	dianzav
truanter	truanter
doutein	doutadouti
braventeziou	braventez
dilavet	dilavet
dirrou	dirrou
zantuar	santual
dielbed	dierbed
amoniac	amoniak
goueledi	goueledi
dizhualet	dishualet
diforc'hein	diforc'hidiforc'hadiforc'h
karmelited	karmelited
Ablamzer	abellamzer
pe	pe
intr	intr
gouilMariaGuenholon	GouelMariaWengolo
lorbour	lorber
anfin	afin
aneizved	eizhved
divorloh	divorloc'h
bresermein	bresermein
cathedral	katedral
taolpennskoaz	pennskoaz
ieued	yeu
urvamenbihue	mammennvev
Liasennad	liasennad
anaoudeg	anaoudeg
didamet	didammet
Dallpikh	dallpik
godiserez	godiserez
pridiriguez	prederigezh
fleuraziou	fleurajo
Parkatil	atil
blac'hkrot	plac'hkrot
arc'hrenizili	krenizili
trist	trist
hadgwelet	adwelout
mafelled'he	fellelfelloutfallout
aretourn	aretorn
bec'hian	bec'hiabec'hi
tranket	tranka
dizeret	dizereet
posterite	posterite
dic'houti	dic'houti
Krogheren	kroger
goualldenvalaat	gwalldevalaat
c'histin	kistin
Disputerien	disputer
aouelet	aouelet
henvelpoch	poch
hunal	hunealhunei
Haderez	haderez
Moustrer	moustrer
distagergeoyer	distager
contadellou	kontadell
nezifuillinket	difuilha
kolera	kolera
drlair	laer
atil	atil
Crapat	krapad
Azidenvo	didevidideva
Betzokoulz	koulz
Setuperag	setu
diazemant	diazezamant
damholl	damholl
toullobez	toullbez
sablen	sablenn
divez	diwezh
yohet	yoc'het
prst	prest
teurnneguedteurennyen	teurenneg
rangaloun	ranngalon
didamet	didammet
moumoun	moumoun
c'hoariellou	c'hoariell
bruzunadou	bruzunad
Kroaz	kroaz
strouilhon	strouilhon
zouaraat	douaraat
didenna	dedennadedenn
disvalet	disvaladisvalat
dic'hoanteguez	dic'hoantegezh
Tanijet	tanijet
ieuet	yeu
krim	krim
qiza	kizakizi
essaou	esa
bechik	bechik
humizellat	izelaat
balustr	balustr
loeinsam	loensamm
Tourta	tourtaltourta
scabelloutoussegued	skabelltouseg
rontt	roud
estlamet	estlammet
nevez	nevez
abeurfollaz	peurfolli
c'houezarfoulet	foulet
divez	diwezh
ehragoap	goap
iragned	iragnenn
koto	kotenn
mournaounet	marnaonet
flemmr	flemmaer
fripponniri	friponiri
tor	torr
breollyou	breol
dispennadurcorf	dispennadurkorf
unt	auntu
daconerez	takonerezh
vargorre	gorre
dispit	dispit
d'	sked
Douarneneziz	Douarneneziz
frondage	frondaj
dizispign	dizispign
brein	brein
charn	charn
arbreferans	preferas
intancius	intasius
fantaziec	fantaziek
blasfemereah	blasfemerezh
erder	herrder
grondinougrondined	grondin
puchet	puchet
harassal	harasal
zoubl	soubl
difforhance	diforc'has
victoret	viktoriviktoari
argourdrousarerdezhan	gourdrouz
Difrouezidiguez	difrouezhidigezh
isfont	isfont
zalmatenein	salmantenni
lappadennou	lapadenn
ahiniennou	ahinienno
sternaoter	sternaoter
Glu	glav
langagereah	langajerezh
boleu	bolo
difin	difina
brejo	brejeo
revoltet	ravoltet
echalbotomp	chalbotat
dantelezi	dantelezi
parahaul	paraheol
grecheneah	kristenezh
viatik	viatik
skuizet	skuizha
ponyu	poan
abiltd	abilded
hardenad	kadranad
peurlaza	peurlazha
Janseniach	jaseniezh
Blenhan	bleuvanhav
gouignbzel	kouignveuzel
Louzaouenarberralan	louzaouennarverranal
Godig	God
droukimpli	drougimplij
amzret	amzeri
penseet	peseet
Nonnik	Nonnig
gwelead	gwelead
muselleguesed	muzellegez
mourouellat	bourouellatbourouella
bistiga	pistiga
izelder	izelder
misonajo	misonajo
cheket	cheka
nec'heta	nec'het
herret	herret
vastikant	mastika
arc'hrignereskern	krignereskern
ac'hruzuil	ac'hruzuilh
derjenvouzar	terzhiennvouzar
avoalstag	gwallstaga
mirakuluz	mirakulus
C'houirinal	c'hwirinalc'hwirinatc'hwirini
arrestance	arestas
fumi	fumafumifumal
letonenn	letonenn
beneguedein	binnigedi
poullcanna	poullkanna
monstrus	mostruus
eurvazroue	bazhroue
gachik	gachig
Nacevitse	evitse
ziouech	diouch
amportemant	amportamant
leson	onn
indoarerh	endouarerezh
dizoania	dizoania
mo	mou
eillavaret	eillavarouteillavaret
Anasqornbelost	belost
ec'h	ez
tuchathatuchat	tuchanthatuchant
gorreaoter	gorreaoter
apeich	ampech
tev	tev
Jeremias	Jeremiaz
argerentiach	kerentiaj
neket	neket
tudnez	tudnes
diguiset	dic'hizet
PorzOliod	PorzhOlued
divroegueah	divroegezh
abardaesvez	abardaevezh
beurzistruja	peurzistruja
avamen	avama
boleat	boleaboleatbolei
faro	faro
pennoukenta	pennkenta
spurja	spurjaspurji
soubitamant	subitamant
ispired	inspirout
promessa	promesa
argastell	kastell
etablisset	etablisa
freuza	freuzafreuziatfreuzi
chutelad	chutellat
kltal	kaolteal
ricin	risin
dibennask	dibennask
lammerigued	lammerig
Encresi	enkrezi
Diframm	diframm
eurc'hofstam	kofstamm
moumoun	moumoun
steredenna	steredennisteredenna
ruroz	ruzroz
gouez	gouez
bardavez	pardaevezh
meanaoled	maenoaled
inclinationo	inklinasion
sabrenn	sablenn
farserez	farserezh
Goroadenn	goroadenn
dizillet	dizilha
galantereah	galanterezh
Braniellat	braniellat
argaden	argadenn
contadellou	kontadell
reigoudord'ign	goudor
zoutein	doutadouti
aspaden	aspadenn
bar	barr
abehkaer	abezhkaer
kementral	kemendarallkementarall
extrior	eksterior
avrhad	avrec'had
Arc'haoleier	kaoleg
arc'hemreg	kembraeg
marapin	rapinarapini
arBevareAmzer	amzer
lac'hadeier	lazhadeg
adammadamm	adammdadamm
goulenn	goulenn
grillet	grilhet
Grucefiereah	krusifierezh
Hiltut	Ildud
revoltet	ravoltet
adruez	truez
Nekuir	nekwir
begad	begad
visioni	misionimisionat
arvestrezplac'h	mestrezplac'h
dic'hri	diwri
fouildret	fouilhdret
aziarben	azirbenn
Qaliteou	kalite
igueded	inged
requintus	rekintus
dic'hlac'hari	dic'hlac'hari
Peurranna	peurranna
bervelet	berrwelet
bigot	bigod
santelaat	santelaat
Gouriaw	gouryev
riblad	riblad
aleizdorn	aleizhdorn
lorh	lorc'halorc'hi
eurvechennamzer	amzer
avieler	avieler
dreo	drev
diglac'hari	dic'hlac'hari
alammploumm	alammplom
parresioukanton	parrezkanton
disqueu	disk
estrewit	estrevit
tramzet	tramzet
andivezadou	diwezhad
pechad	pezhiadpezhad
dizebezet	disebezet
Toulllouarn	toulllouarn
syellet	siellasielli
divroad	divroaddivroiad
dilotet	dilotet
pave	pavez
sigur	esigur
hbrus	hebruz
zispital	dispitadispital
zianvet	dianvet
scrij	skrij
droherioncoet	troc'herkoad
kesten	kistin
foran	foran
avostadeu	avostado
fallgaloun	fallgalon
avrahad	avrec'had
iaoufask	YaouBaskYaouFask
dafia	tafia
licheryou	licheri
aretourn	retorn
Germanet	German
leunchec	leunchek
carnet	karnet
glaw	glav
hadkeuneud	hadkeuneud
jeinemant	jenamant
furchethadifurchet	difurchal
relation	relasion
zaoreleg	savreleg
Lennou	lenn
divadezet	divadezet
douj	douj
livaden	livadenn
Kornzigor	kornzigor
Dominiq	Dominik
ssonnet	saesonetsaezonet
berrentez	berrentez
seudanec	saouzanek
fatigus	fatikus
divoueded	divouedet
amzevosion	amzevosion
ervamgouh	mammgozh
stocandez	stokandeiz
tomaden	tommadenn
ez	ez
skas	skas
guinal	gwinal
dijanchet	desacha
enorapla	enorapl
degaget	degajet
zularPuslard	peuzlard
urvezennad	gwezennad
dizoan	dizoan
arc'hirriadan	karradan
ar	bir
stlacqou	stlak
Glozard	glozard
varzioual	warziwall
consolus	kosolus
II	uz
Ribouldiriboul	diriboul
troiopleg	trobleg
ispridettan	ispridet
Kastellan	kastellan
stribillenna	stribilhenna
Reogwenn	revgwenn
banklabour	banklabour
mn	men
poud	pout
ereguemr	regemer
touet	touet
forbanet	forbannet
amnoh	amen
reizet	reizhet
benezet	benezet
diroll	diroll
diranget	dirajet
Cato	Katou
divarc'heresdorejo	divarc'herezdorojo
dianzao	dianzav
enemzepita	depita
Croudigez	krouidigezh
disco	disk
douellus	touellus
gchogchobihan	gcho
kildroadur	kildroadur
Divirous	deverus
suspdus	suspedus
oall	gwall
adreuzdidreuz	treuzdidreuz
Vourgez	Bourjez
erspont	spont
chilp	chilp
ravolt	ravolt
voaperez	goapaerezh
bascanad	baskanad
arVelandinen	melandinenn
Sina	Sina
gabeleskop	kabelleskob
Beza	foran
Moumoun	moumoun
autegraf	otegraf
Delfinez	delfinez
victim	viktim
loreiloirei	lovralovri
digervel	dec'hervel
tuemzr	tommzer
varc'horre	warc'horre
zourrigal	sourrigal
difianus	difiziasus
Foulc'h	foulc'h
foubenn	foubenn
lipenhalapen	lipennhalapenn
gwal	gwall
reklen	renklenn
drogach	drogaj
prevedlugern	prevlugern
scod	skod
gourenesy	gourenez
spouronus	spouronus
vezimniavell	awell
purnez	purnezh
tobios	tobioz
tarkjertarvokjer	tarvkazh
inied	inia
mahomryen	mac'homer
enemzifraoia	difraoia
Dalvez	dalvez
Lezdastorlok	storlok
ravach	ravaj
askiantvad	skiantvat
scanvigen	skavijenn
edbrezelidi	brezeliad
erc'hornpleg	kornpleg
c'hlasvezi	glazvezi
education	edukasion
clemuchat	klemmuskat
tintampar	tintampar
scodou	skod
plein	plaen
penfond	pennfont
scrintellerez	skrintellerezh
rikamana	rikamana
klenkwarnhan	klenk
arC'houmblidou	komblido
c'huezadur	c'hwezadur
pardaeznoz	pardaeznoz
crouidigez	krouidigezh
sigur	esigur
prajeyer	pradtirien
skouiz	skuizh
gou	gouez
crozal	krozalkroza
dizao	disav
livrisa	livrizh
anatdioc'h	anat
telio	deliaouenn
ebatoahedoare	ebat
Morlivid	morlivid
gourdrouzereah	gourdrouzerezh
guezdero	derv
brizlenn	brizhlenn
arc'hbreuriez	arc'hbreuriezh
kikastenn	kigastenn
inutilamant	inutilamant
meudeusinaj	medisinaj
victorein	viktoriviktoari
veuzen	veuzen
baleanted	baleant
drodeu	droaddroed
enemhardizan	hardizhahardizhat
goudouer	goudor
Anat	anat
egras	egras
comboujou	kombod
ridicul	ridikul
peurzeski	peurzeski
fabric	fabrik
aviziken	aviziken
mann	mann
byellou	biell
Kivor	kimor
BecgDouar	begdouar
Kleizdour	gleizdourgleizhdour
digropet	digropet
broc'higargwenan	broc'higargwenan
margaloneg	margalonek
docil	dosil
requinage	rekinaj
Divodest	divodest
ral	arall
arc'halir	kalir
alouberien	alouber
zec'hor	sec'hor
Maotvelen	maotvelen
amandez	amandez
qordennad	kordennad
Spek	speg
begadou	begad
azornadeu	azornad(o)
Penduik	pennduig
ed	gidaz
rabin	rabin
dislealamant	dislealamant
truezouzomp	truez
dic'hizet	dic'hizet
dibord	debord
fassated	fasataet
afourga	fourgasi
kouhlaieu	kole
blank	blank
nebaoun	nebaon
caloned	kalonet
diaket	diaket
leurzy	leurzi
abilite	abilite
urvesaeres	maesaerez
bagatelleu	bagatell
hortauzit	hortaozit
divent	divent
porzmeur	porzhmeur
stouvet	stouvet
drougcalon	drougkalon
c'hlasvezi	glasvezi
erbromesse	promes
anrejistramant	arejistramant
suillaarvirionez	suilhasuilhi
digalon	digalon
enembareas	parea
misonet	misonet
barvegez	barvegez
bninou	abenneno
rezinen	rezinenn
gouihuan	gouez
escypsas	sklipsi
pacqou	pak
afa	afa
andudaboan	poan
dellezour	dellezour
reclom	reklom
sa	sa
guenel	gwennel
Epebent	hent
ravechou	ravent
pareed	pareet
skrigndent	skrigndent
Urban	Urban
turriet	turiet
basefoz	basefos
lastruz	lastrus
ascaout	askavout
aflao	flav
sansibl	sasipl
Delliddellit	dellid
erder	herrder
truflerezo	truflerezh
dreroudou	roud
didatek	dizanteg
diaulmud	mut
enemzifres	difres
hitropic	itropik
ingalded	ingalded
breffamant	brefamant
bida	bida
nebon	nebaon
foetfak	foetfank
tana	tana
loskus	loskus
arc'hegit	kegid
venjus	vejus
mailluret	mailhuret
pourchaset	pourchaset
dourioubeuz	beuz
Tsseeu	tez
boustouf	boustouv
lodenneker	lodennek
impar	ampar
gourvamgoh	gourvammgozh
Arouezet	arwezet
inclasquerion	enklasker
zouhet	souezhet
kombod	kombod
dislea	dizlea
gloeier	glav
barbar	barbar
rannour	ranner
efrinkashagetifrinkas	difrinka
diffoutre	difoutredifoultre
vangeancius	vajasius
randounen	randonenn
gouivd	gouez
dorchan	torchatorchi
peulpost	peulpost
dihalpet	dihalpet
qenidervesedcomps	kenitervgompez
dirodet	diroda
stourmad	stourmad
dourdiwask	dourdiwask
bir	bir
lucuen	louezaenn
treina	streina
meanfons	maenfos
lorhein	lorc'halorc'hi
dizanaoudegez	dizanaoudegezh
itropeq	itropik
bleguet	daoubleget
Galilea	Galilea
arluetdiouthan	harluaharlui
stourmad	stourmad
skiltr	skiltr
c'harante	karantez
huan	huanhue
autresi	aotrezi
varneranniliz	barnerIlizbarneranIliz
didamman	didammadidammi
dantier	dantier
in	aeno
melconied	melkoniet
hedanollamzer	amzer
querheisquerhair	kerc'heiz
damn	damn
gobdevezour	goprdevezhour
urvezenpalmez	gwezpalmez
dudius	dudius
Aotervraz	aoter
Tugdual	Tudwal
alamanden	alamandenn
entanet	entanet
arc'haban	kaban
briolage	priolaj
ravnd	ravent
maltre	mart
melen	douarmelen
lipet	lipet
dilladvele	dilhadgwele
estlamed	estlammet
antervreur	hantervreur
druillennek	truilhennek
Astaol	astaol
varzibrad	warzibrad
divroad	divroat
golead	gwelead
breta	brete
urhordon	kordon
ridgoaid	redgwad
Penduik	pennduig
balustraden	balustradenn
dizroullans	dizroulas
in	eno
seblantuz	seblantus
foudralis	foudralis
chicoloden	chikolodenn
filosof	filozof
ereahechoumadur	chomadur
promesaou	promesa
takon	takon
edkerzhin	kerzhinenn
vikeleach	vikelajvikeliaj
Staoter	staoter
zikourouz	sikoursikouri
abadrves	abardaevezh
ansouhettoh	ansouezhet
qarr	gwalenngarr
caniet	kaniet
damdon	damzon
leunchec	leunchek
evesdet	evezhded
superstisionou	superstision
difreguet	difreget
tamtam	tamtam
shedigueah	sec'hedigezh
arc'hleder	kleder
caffer	kaver
venjansus	vejasusvejasius
enemharpaz	harpaharpi
bourrussoh	bourrus
souc'het	souet
Minvroud	minvroud
zouellerez	touellerezh
Froudenna	froudenna
enemspurja	spurjaspurji
adrouc'htranch	troc'htrach
erBarrss	pares
atil	atil
bavard	bavart
astrabil	astrabilh
adrocont	adrokont
tivaloa	divalava
dineat	dinead
warwintel	warwintel
d'amgrons	damc'hros
aasfeillo	azfeilhi
iuzeo	yuzev
itik	itik
dirange	diraj
glouistr	gloestr
Eursizunvezioubennag	sizhunvezh
avriadkaer	avriadkaer
Agreis	agreiz
Crughellmerien	krugellverien
Ormandie	Normandi
didou	didou
eurvilinesken	milinheskenn
II	kel
lisquidussa	leskidus
arvreac'hzu	brec'hzu
diaonig	diaonik
angls	anglez
lussird	lusier
alintraz	lintralintri
aribl	aribl
breinadur	breinadur
pouliz	polis
bourret	bouret
drgreiz	dregreiz
akoutri	akoutri
askiant	askiant
hellest	kanastr
sperejoDoue	speredoDoue
didach	didach
fleurachi	fleuraji
penivinet	pennivinet
enemdic'hrocha	dic'hroja
reage	revaj
alamtourtarkaz	alammtourtargazh
ac'haoliet	gaoliad
stuiet	stouet
batoni	patoni
o	koll
eurc'hlec'h	klec'h
venjus	vejus
urhardriad	kardeuriad
brehguen	brizhgwenn
reniour	reneer
enemzic'hlac'haras	dic'hlac'hari
divoc'h	boc'h
Siet	siet
freuzo	freuzafreuziatfreuzi
platenneneu	platinenn
Gwazennvor	gwazhennvorgwazhiennvor
Klemvan	klemmvan
arc'hrenalter	krenalter
fouin	fouin
strelikes	strelikez
benezet	benezet
zizalla	dizalla
aoe	test
liant	liant
dellidou	dellid
diluc'het	diluc'ha
enezenad	enezennad
turiellerdouar	turiellerdouar
horerus	orrolus
lucha	lucha
diagned	diagon
sa	sa
petare	petare
agripoah	agrizpoazh
abadma	abad
digoustians	digoustias
fronellou	fronell
diskuill	diskuilh
obercompagnunezdezhan	kompagnunezh
mitieret	mitieret
enerhussa	nerzhusaat
sentabl	sentapl
flac'hou	flac'h
ebeuleuzed	ebeulez
kentraouet	kentraouet
varartiklarmaro	artikl
taulpesked	pesk
losthed	losthed
bodennet	bodennet
formidabl	formidapl
salad	salead
adreuzhagahed	adreuzhagahed
mamoukoz	mammgozh
krec'hillek	krec'hilhek
aberjoausaaz	peurjoaiusaat
zireoli	direoli
dissorbet	disorbet
inourabl	enorapl
gaffrgoez	gavrouez
taolru	taolru
roudienet	roudennet
guinerez	ginerezh
mentuka	meudika
onganti	onganti
Chal	chal
meri	merameri
guioc'hed	gioc'hkioc'h
pennaraog	pennaraog
heuen	huanhue
adreushacahed	adreuzhagahed
entronozda	entronoz
Corbiner	korbiner
Agreiztout	agreiztout
azelaouaz	goulenn
huan	huanhue
digoustianz	digoustias
ariolennadeu	ariolennado
lic'hiduz	lec'hidus
arc'horaden	goradennyer
discouraget	diskourajet
moust	moust
douj	douj
Nil	Nil
graamant	greiamant
ouallalli	gwallali
Torchit	torchatorchi
arumderum	arummdarumm
ac'hlasvezas	glasvezi
gwerc'h	gwerc'h
Thuriu	Turiav
pokholpoyol	pokiol
pedare	petare
anfin	afin
diranget	dirajet
alivadou	alivado
lousnach	lousnaj
goutab	goutapl
hent	hent
loenedsamm	loensamm
Kaouanen	kaouenenn
LouzaouensantBnad	louzaouennsantBenead
Mardoustac'h	mardoustac'h
arpompouz	harpaharpi
enterred	interet
tiridignat	diridignat
murmulou	murmur
splander	splannder
poliz	polis
ingunage	ingennaj
pluet	pluvet
leziobarnlezvarnio	lezvarn
abadm	abad
dilabour	dilabour
argrenedeg	krenedeg
moudenned	moudenn
guic'hal	gwic'hal
bugalah	bugeliezh
freozrup	freoz
fahuen	faouenn
Strapa	strapastrapat
munud	munut
col	koll
leveour	leveour
librance	libras
dohurret	red
Verleac	Merleag
tao	to
kours	koulz
disconterez	diskonterezh
enemzunta	sunta
vatand	vatant
goalgustum	gwallgustum
ac'harden	ac'hardenn
amhouyance	amouizias
jaujabl	jaojapl
dizacr	disakr
tirandus	tirantus
yalhbutum	yalc'hvutun
qignezegou	kignezeg
ezansoer	ezasouer
wardestum	warzastum
poullaounez	poullhavouez
mandogued	mandog
sansipla	sasipl
ascana	askana
dimez	dimeus
ratik	ratik
divaskellek	divaskellek
ollgarantezuz	hollgarantezus
agompetezeuz	kompeta
knevyet	krevia
aviziken	aviziken
galei	kalir
meingriz	maengris
ribincq	ribin
Loupenn	loupenn
pezad	pezhiadpezhad
helmourou	helmoer
Yvonaik	Ivona
tenneris	tenneris
erral	arall
diyahus	diyac'hus
enemizelaat	izelaat
Goafergwafer	goafer
pennkenta	pennkenta
luza	luza
hebiou	drebiou
dishavalet	dishavalet
strakerienlann	strakerlann
guinver	gwiver
erc'hombot	kombod
frak	frag
entanet	entanet
enkrougeuz	ekroug
Avaman	avama
anebeudouigou	anebeudoigo
aziabellguelet	aziabellgweled
merag	merak
fohonage	poc'honaj
d'eben	ebenheben
portughs	portugez
astdeu	asteudo
dallput	dallput
urblanonnen	plasonenn
Paalier	aliaalii
mudez	mudez
Daouc'hant	daouc'hant
astenned	astennet
dibled	dibled
dic'hoanteguez	dic'hoantegezh
dousik	dousik
pin	pin
despeigni	despegni
barbouellet	barbouellet
masmean	masmaen
divlas	divlaz
Glazc'hoarzin	glasc'hoarzhin
diavaezidi	diavaeziad
dromperi	trompiri
spered	debret
demeus	dimeus
pusuniet	pusuniet
papertimbr	timbr
isch	iskuizh
urhuenpalms	gwezpalmez
stribillet	istribilhet
mahet	mac'het
riblein	riblaribli
keuneuded	keuneudet
dizouil	disouilh
brillantoc'h	brilhant
scrij	skrij
Disal	disaldisi
qemenryenvor	kemenermor
rederpri	rederpri
goulc'har	goulc'her
porzmeur	porzhmeur
Coummannaiz	Kommannaiz
Gadoreskob	kadoreskob
caractrieu	karakter
finvad	finvad
cajolus	kajolus
divilid	diverit
pellen	pellenn
dermat	termaltermat
laouenidigez	laouenidigezh
taolru	ru
demeuz	dimeus
coagri	koaga
eurgadorbortez	kadorbortez
orglseu	orglez
flouradergalon	flouraat
touyereaheu	touerezh
Mignouneta	mignoneta
trabasser	trabaser
izela	izel
druillia	truilha
marc'hglaour	glaouaerglaouer
bragaouet	bragaouet
scavelarded	skavelard
pitik	pitik
flipa	flipaflipatflipi
Dagenver	dagever
spoes	poes
pressouer	presouer
aroarscrigndent	skrigndent
mouguereah	mougerezh
peurzila	peursila
calmed	kalmet
offertour	ofertouer
Urban	Urban
wardastoun	wardaston
diwoarvar	diwarvar
zenalezen	denalezenn
Suhunourrnerion	sizhuner
lazidigesiou	lazhidigezh
delivrans	dilivras
keitall	all
chouket	chouket
eurc'harbount	karrbont
aotervraz	aoter
rimadella	rimadella
sentusous	sentus
disurzou	dizurzh
tisfi	disfizioutdisfiout
persvrance	perseveras
bourus	bourrus
doutec	touteg
trzhatrzd'	treuzhatreuz
porskloz	porzhkloz
Spinac'ha	spinac'haspinac'hi
aanter	ahanter
stoupaerien	stoupaer
enepmann	mann
o	chour
koant	koant
margeu	marko
choumwarziaskren	diaskren
tana	tana
dishentcha	dishenta
dife	difeiz
dizikour	disikour
grennegellek	krenegellek
blazahadivlaza	divlaza
blansounet	plasonet
zero	derv
Taltous	taltouz
simplamant	semplamant
bourmeni	pourmenpourmeni
Branguilly	Brangilli
aisprid	aisprid
glaoyer	glav
suner	suner
daouugent	daouugent
visenAvnd	Azvent
pesquetarion	pesketaer
berdler	peurdeurel
tourioutan	tourtan
erstalgostez	astalgostez
relia	relia
mecherourpleg	micherourpleg
krennakrenn	krennhakrenn
pistiget	pistiga
jostram	jostrom
mouchourjubile	mouchouerjubile
ezeden	dedennadedenn
luhrieu	luher
tredemars	tredemarzh
maroni	maroni
rip	rip
onganti	onganti
koac'ha	koazhakoazhi
ankounac'had	ankounac'haat
yac'hbeo	yac'hbev
chagrin	chagrin
impar	ampar
normand	Normand
deolediguez	deoledigezh
ledandd	ledanded
sagrin	chagrin
uz	uz
sioulec	sioulek
eurvagfroderez	floder
reputation	reputasion
awe	awe
trs	tres
frounlleryen	froneller
arc'houarnamant	gouarnamant
fleur	fleur
Vantredie	vantredie
enemrei	rei
pennbizyer	pennbazh
aziwardro	aziwardro
guallElez	gwallael
Petore	petore
bokodzadJozeb	bokedsantJozeb
nizez	nizeznieznizh
anderzienvelen	terzhiennvelen
dispar	dispar
lzpeket	laezhpeget
couzoumenni	kouzoumenni
talvouduz	talvoudus
aharp	aharp
margaloned	margalonet
Brezeliad	brezeliad
Peur	peur
urvlazenn	blazenn
talvouduz	talvoudus
Japon	Japon
morgenn	morgenn
yuzerez	yuzerezh
Qellid	kellid
soup	soubl
demvelen	damvelen
amzergers	amzergers
Roud	roud
liboustec	liboustek
adlevezo	dlevezout
scraberez	skraperezh
hoarielleu	c'hoariell
wazpewaz	gwazhpewazh
grek	grek
vouchadou	avouchado
aberscleraio	peursklaeraat
gic'hat	gwic'hal
n'ousketpet	nousketpet
cabanennou	kabanenn
henvelpoch	poch
adreushacahed	adreuzhagahed
dizesc	dizesk
nevezet	nevezet
Mardoust	mardoust
sorc'heni	sorc'hennasorc'henni
avrehadeu	avrec'hado
ciudis	siudis
apreste	aprest
divargount	diwargont
emganna	emgannaemganni
kadeurEskop	kadoreskob
Monika	Monika
drboen	poan
lorbour	lorber
gut	gweet
importune	importuni
Dallpoch	poch
Divodrage	divoderaj
karrarmaro	karrarmarv
brev	brev
rukunuz	rukunus
Trugar	trugar
drevaroudou	roud
digor	digor
mann	mann
disanve	dizanavez
pourceln	porselen
all	all
takezen	takezenn
dissorb	disorb
avryadcar	avriadkaer
kalmouk	kalmouk
Redemsion	redempsion
Ave	ave
Breta	brete
SantVazePennarBed	SantVazhePennarBed
penaska	pennaska
ludusitr	ludusitrludusit
dagantifi	kantdifia
becqedigou	beked
urbvarenn	pevarenn
Taffou	taf
transfiguration	trasfigurasion
azgwerzet	azgwerzha
Avitin	avintin
glasktrabasouc'h	trabas
fanfarluchou	fafarlucho
oall	gwall
Leok	leog
menpost	maenpost
letonenn	letonenn
eurc'harziat	garzhadgarzhiad
warhegrabosou	kraboso
gleu	glav
porc'helgouez	porc'hellgouez
digloz	digloz
goallbaea	gwallbaea
pennfollet	pennfollet
druillennek	druilhennek
creyeryod	krogyod
kadeurvarn	kadorvarn
godissogodisset	godisalgodisa
ebort	hebort
ehadretorne	adretorn
ankoua	ankoua
vastinguet	vastinget
penveuzet	penveuzet
abuset	abuziabuz
eurbaludenn	paludenn
disenoui	dizenoei
voeltrach	foeltraj
assurentez	asurentez
skuiza	skuizha
dervesiad	devezhiad
santleit	santelaat
sclat	skolaat
deliable	dleapl
tadargeier	tadargaouargevier
avitin	avintin
Fanch	Fach
dizaounica	dizaonik
dic'hiseten	dic'hizet
intru	intru
laskroug	laskroug
gwallstad	gwallstad
devrranceu	diverras
gaout	truez
sanklet	sanket
dissouill	disouilh
peskedcrogennog	peskkrogennek
kasta	kastra
profanein	profani
ergrollers	korollerez
echal	chal
grillet	grilhet
Karvik	karvig
poazidic	poazhidik
adruez	truez
arc'hroaziou	kroaz
endouadell	touadell
beobuez	bevbuhez
pebrourou	pebrouer
reposvan	repozvan
talmeta	talmata
ingalaningalou	ingal
sc'horiou	sec'hor
digor	digor
arahet	areuzhet
skoagleu	skoazkleuz
aemganne	emgannaemganni
graeoc	graeek
fallgalon	fallgalon
chinad	sinaat
seblant	seblant
n	e
fossel	fosell
endefediskredvar	diskred
arvouamant	mouvamant
argalc'hei	kerc'heiz
urvezennad	gwezennad
dizatren	dizantren
Tineller	tineller
guivt	gwiv
dic'habouz	dic'habous
urhoust	goust
peushir	peuzhir
Dec'hradi	dic'hradadic'hradi
noazoutdehoc'h	noazoutnoazinoaz
laeronmor	laermor
reihhasplann	reizh
pataoec	pataveg
beveach	bewechbewezh
Pipia	pipial
goulaouideiz	goulaouideiz
prehesion	predesionprehesion
kuzet	anat
diatant	diatant
alair	alaer
rouch	rouch
dossereah	doserezh
glanvadurez	klavadurezh
blanchein	plachi
grostenn	krostenn
vourlogod	vourlogod
janablou	janabl
Cathelin	Katelin
etitiruiller	didiruilha
em	aez
lampout	lammatlammetlammoutlammilampatlampout
gourlosket	goulosket
inouet	enoeet
pourvuet	pourvui
cahieret	kaieret
rebutein	reputareputi
moc'herez	moc'herezh
arko	arko
diskuzet	diskuzha
lec'hiennou	lec'hienn
murmurerez	murmurerezh
stol	stol
falamzer	fallamzer
dispidi	dispedi
riddeur	reddour
feal	feal
Reilufrda	lufr
anfin	afin
dizalla	dizalla
didroel	didroell
avgad	begad
diouallerez	diwallerez
piketgrisias	piggrizias
culei	kulakuli
dilavet	dilavet
drougizili	drougizili
c'houarnamant	gouarnamant
groeitseblantmaterbet	seblant
dic'hoarzet	dic'hoarzhet
diloc'het	diloc'het
setim	setim
taltouz	taltouz
begdouar	begdouar
dizursiou	dizurzh
rontt	roud
petezenn	petezenn
post	poz
galantage	galantaj
ascre	askre
kourtaj	kourtaj
difiadeg	disfiziadeg
ludufin	ludufin
divent	divent
ignam	ignam
ravodereziou	ravoderezh
lusquemanteu	luskamant
Hollata	'ta
enemdana	tana
reusklen	reusklenn
dimez	dimez
oberarfurch	furch
Asa'tamat	'ta
meget	mega
enemzislea	dizlea
direzed	derezet
mstrpost	mestrpost
skeudennet	skeudennet
guallstad	gwallstad
horrerus	orrolus
chifa	chifachifalchifi
luban	luban
soken	zoken
Aslavarout	azlavarout
Arbennegez	pennegez
roufennet	roufennet
ribin	ribin
tirennet	tirennet
rollad	rollad
wareno	eno
dizoan	dizoan
displica	displika
Ergestenen	kistinenn
diveoc'h	diwezh
mestrboutailler	mestrboutailher
yeinoni	yenoni
kalfichadur	kalfichadur
semplet	semplet
ravolt	ravolt
azigas	degasdegasi
oc'h	ouc'h
piastr	piastr
Asfeilli	azfeilhi
bennnemeur	abennnemeur
dribu	tribu
dic'hounez	dic'hounez
zedra	sedra
aziarskan	azirskav
gouiv	gouez
viscadur	gwiskadur
Glaouaerien	glaouaerglaouer
diencrez	dienkrez
d'ino	eno
peuraliesoc'h	peuraliesoc'h
arancad	arenkad
tarhgoleud	tarzhgoulodeiz
vir	bir
kriellek	kriellek
Gwidret	gwidreet
keithakeitall	keithakeitall
adreuzas	treuzitreuza
Randonenn	randonenn
blank	blank
tremenkuhaka	kuhaka
vnonni	venoni
maladennou	maladenn
cambreuenhaul	kambroanheol
exerci	egzersi
eunan	eunan
grateit	grataet
ankounac'haat	ankounac'haat
peushenvel	peuzhevel
Pitouch	pitouch
divoucher	divouchergoulo
Vardroeno	eno
hirscouarnet	hirskouarnet
Pismigal	pismigapismigat
Diorroit	diorren
ind	int
diforhet	diforc'hidiforc'hadiforc'h
dreirnez	hirnezh
grognus	grognus
poz	poz
alouberez	alouberezh
Conan	Konan
Ervenojenn	gwenodenn
Krogennperlez	krogennberlez
dreeno	eno
tuffec	tufektufevek
liboust	liboust
enemdarafad	tarafat
discalon	diskalon
benadurez	benadurezh
Profesia	profesiaprofesii
aezeteasd'ezhan	aezetaat
henthouarn	henthouarn
affiet	afiet
efidandomen	efidandomenn
ainou	eno
abenino	eno
goalstad	gwallstad
renoumad	renou
dleourien	dleour
aretorn	aretorn
Zero	derv
diar	dir
kraoennfaou	kraofaou
c'huybanadou	c'hwibanad
friponage	friponaj
fourgazet	fourgaset
Pintekhpintekh	pintik
aoulaj	aoulaj
hual	hual
avad	avat
bruhun	bruzun
butunkarrot	butunkarot
glapezennou	klapezenn
dibrezet	dibreza
keuiek	keuziek
skeduz	skedus
lojamanchou	lojamant
envnglaz	evnglas
sdraad	sederaat
goalbedenneu	gwallbedenn
mac'hagnou	mac'hagn
phenbaz	pennbazh
Dihuigut	diviget
enemzic'hlac'hari	dic'hlac'hari
billejou	bilhedvot
divoutou	divoto
gomor	govor
erbaladeg	paladeg
reizvuele	reizhwele
renevezi	renevezi
sontal	sonteal
kokanan	kokanan
dic'hiz	dic'hiz
poellus	poellus
bourret	bouret
fonhur	foevour
Diatat	diatant
aret	aeret
foulgonze	foulgomz
houilmikl	Mikael
konfitur	kofitur
eurgouskaden	kouskadenn
argamz	kamz
aretorn	aretorn
scnvadurez	skavadurezh
Fard	fard
koateet	koataet
galite	kalite
raeden	razhedenn
oberiou	ober
gradvad	gradvat
Gaoliad	gaoliad
ziskargerguin	diskargergwin
abezkaer	abezhkaer
boufonage	boufonaj
Rodell	rodell
Neankounac'haimpket	ankounac'haat
holernihuel	gwalarnuhel
dregreiz	dregreiz
aorgell	horgellat
egras	egras
olbuissance	hollbuisas
kaoudad	kaouedad
elvennoutan	elfenndan
abiglammou	abiklammo
eurvourc'haden	bourc'hadenn
scrij	skrij
entouerDoue	evntouerDoue
aroudennou	aroudenno
azokompez	kompez
gourzavet	goursavet
mzvyeresed	mezvierez
bepanamzer	amzer
sac'hellok	sac'hellek
lipad	lipad
chismatikerez	chismatikerezh
penuvr	penneuvr
varcan	marc'hkav(o)
konferansi	koferasi
berrentez	berrentez
violdet	violedi
reihhasplann	reizh
zifiziout	difiziout
neankouefez	ankouaat
skipartein	skiparti
gronchet	grojet
Iya	eya
brehunadeu	bruzunad
aziadost	aziadost
Listren	listenn
Taolspl	sple
dizispin	dizispign
avihantra	avihantra
digapapl	digapapl
beteneuze	beteneuze
adret	adret
treuzdidreuz	treuzdidreuz
abriein	abrii
torrimelet	torimellet
palyourod	palrod
aiawarheourzik	ourzig
asdalc'het	azderc'hel
arac	arak
foubenna	foubenna
eurmarvaillou	marvailh
chouri	chourachouri
Krazo	krazo
gvoallgavet	gwallgavet
ampir	ampir
uz	uz
diveramzer	diverramzer
tourtan	tourtan
arC'hloastrPlourin	KloastrPlourin
koant	koant
dishorellet	dishorellet
zisvantri	disvantri
varstokhelanchen	lachenn
Parbleur	parbleur
splanndr	splannder
forzediguezou	forzhidigezh
delivrans	dilivras
urgamdro	kammdro
zizursiou	dizurzh
garjeta	garzhata
diboell	diboell
hoeiz	eizh
form	form
gwenterc'henn	benterc'henn
avandennad	avandennad
silaouret	soulaouret
isplika	isplika
dizakr	disakr
GouilMariacreisst	GouelMariaKreizEost
kc'heler	kac'herer
dic'haouet	dic'haouet
fonnabl	fonnapl
dispeg	dispeg
vennoz	vennoz
oc'hunan	hoc'hunan
brazkempenn	braskempenn
zrepaz	trepas
baillardigueah	pailhardigezh
heurtellai	heurtelli
goalarnster	gwalarnster
Liketa	liketa
mahet	mac'het
disklommein	diskoulmadiskoulm
bourrus	bourrus
blocuri	plokuriplokuli
divelc'houedi	divelc'hwedadivelc'hwedi
Spevia	spevia
merag	merak
razok	razek
mamgar	mammgaer
ezommus	ezhommus
amparfall	amparfal
karantek	karantek
aslavar	aslavaroutaslavaret
Fourchad	fourchad
talvdus	talvedus
disfi	disfizdisfi
zeliu	deliaouenn
aribl	aribl
Koublad	koublad
adoullado	adoullado
ascre	askre
c'houeria	goueria
eskamed	eskemmez
mezidigez	mezhidigezh
dizispign	dizispign
liqes	likes
bolead	bolead
Kerne	KernevKerne
B	sil
dereadez	dereadezh
diverdet	diverdet
gantho	foran
aaccordvad	aakordvat
Bourruss	bourrus
diblas	diblas
pin	pin
koant	koant
goulc'her	goulc'her
areguemras	regemer
vrinien	brinienn
noblechin	noblechin
misenavnd	Azvent
sclage	skolaj
chopet	chopet
diveramzer	diverramzer
eurbluenerc'h	pluerc'h
Toekennat	toekennad
voaziet	gwazhienn
gaudisseres	godiserez
arstru	rstrew
echal	chal
miritussoc'h	meritus
toubleal	doubleal
malgrce	malgras
trousryen	trouzer
difeisa	difeiz
mild	mildie
fraodu	fravdu
autor	aotor
humplaat	humplaat
ebrofsias	profesiaprofesii
brehoneu	bruzun
brechin	brochenn
folezi	polez
gardian	gardian
warbennneuze	warbennneuze
dijadennet	dichadennet
arabet	Arab
troc'hergoulou	troc'hergoulo
esperjereah	asperjerezh
eunndrugar	trugar
Govorgor	govor
branellotreid	branelldreid
Bazar	bazar
abadaouet	abadaouet
dreistbord	dreistbord
krabinad	krabinat
falskredenn	falskredenn
hinkane	inkane
aviet	aviet
glouhet	glizhetgwlizhet
skoran	skora
hentedigez	hentidigezh
erezaz	ereziereza
braead	braeabraealbraeatbraeiatbraei
zigrdereah	digrederezh
enemizellaat	izelaat
enouet	enoeet
scorfou	skorf
aredfors	aredforzh
arzd	arsot
avriadou	avriado
tiscouragemant	diskourajamant
gwallaelez	gwallael
noazoutoute	noazoutnoazinoaz
frouezmir	frouezhmir
azindanzivin	azindanzivin
bourust	bourrus
Aksiatet	aksiantet
garakter	karakter
touriotan	tourtan
dervesiad	devezhiad
Pistiguet	pistiga
chomendiascrenn	diaskren
moust	moust
mestrarmo	mestrarmo
gouloucoar	goulaouenngoar
avemor	avemor
enemharpa	harpaharpi
aziaoul	aziaoul
peurnetaat	peurnaetaat
II	pe
zic'hoantaad	dic'hoantaat
dic'henedet	digenedet
bastard	bastardez
istampieu	istampio
diabadaouas	diabadaoui
troubl	troubl
dizarb	dizarb
echoumanablass	ablas
dalc'hmad	dalc'hmat
tivodestis	divodestiz
rebechou	rebech
crapisent	krapisa
zroyouplek	trobleg
test	test
ituenutuen	edduenn
honestadur	onestadur
vagatellage	bagatellaj
Foran	foran
dizer	dizeur
diann	dienoe
aretorn	aretorn
rebech	rebech
stol	stol
zantparon	santpaeron
eundommaden	tommadenn
kirritan	karrtan
desert	dezert
scrigndent	skrigndent
Mac'h	mac'h
meanpont	maenpont
malgrce	malgras
urgadorpredg	kadorbrezeg
tint	tint
kalounadik	kalonadig
pilcojou	pilkaozio
diskrignet	diskrognet
gefia	kefia
dleour	dleour
limage	limaj
revolt	ravolt
rannet	rannet
kleuieres	kleuzierezh
iodbizin	yodbezhin
dorneri	dorniri
obervazilvidiguez	silvidigezh
sex	seks
arendaren	arendaren
glanguen	glanwennglangen
sklasi	riv
arc'houblad	koublad
Goennglao	glav
diferm	difeurm
boustouf	boustouv
adroc'htranch	troc'htrach
hadkemer	adkemer
flastrethadifflastret	diflastra
dellido	dellid
Enemrei	rei
ahndaral	arall
bemdezordinal	bemdezordinal
adreuzhagahed	adreuzhagahed
dizesk	dizesk
SantNeven	Neven
cetu	setu
ridicul	ridikul
eclasceribinou	ribin
efonnou	fonni
Choufretez	soufretez
magegorf	magegorf
ali	ali
barnerabeoc'h	barnerabeoc'h
saotol	savtaol
ec'haskavas	askavout
droieukam	trogamm
dourbill	dourbilh
follez	follez
neval	aneval
diamnd'	diamen
azizunan	dizunani
elhus	helc'hus
avelkaer	awelkaer
rannvroat	rannvroat
offerenneured	oferenneured
avah	avac'h
ledanded	ledanded
lorber	lorber
enemziboania	diboaniadiboanii
skedus	skedus
compesennadou	kompezennad
Anjina	ajina
breta	brete
guinaudren	gwenodenn
reizamant	reizhamant
priet	priet
aruannad	aroevat
Gentiled	jentil
forbanet	forbannet
aberzkaer	aberzhkaer
Kamleziz	Kamleziz
tommbero	berv
keferet	keferet
dieveset	dievezhet
difeiz	difeiz
Adravir	adrawir
uz	uz
cheleuettan	selaouet
redadeg	redadeg
Isabel	Izabel
brankodet	brankodet
kupennek	kupennek
euningroeztud	engroez
dinahein	dinac'hidinac'hadinac'h
amiablemant	amiaplamant
gwireed	gwiraat
bosein	boseal
aretorn	retorn
avac'h	avac'h
ispirout	inspirout
rozel	rozellforn
nehoalsplannouquet	gwallsplanna
neuennat	neuvennat
riboul	ribouldiriboul
c'hogeal	gogealgogeagogei
erberseverance	perseveras
arc'houezidi	goueziad
rifortirvin	rifordirvin
brenadur	breinadur
fidelamant	fidelamant
daouc'hant	daouc'hant
adoreurien	adorer
Guinal	Gwinal
d'egaout	dagaout
ehoal	gwali
Gres	Gres
diseur	dizeur
awallrebecher	gwallrebech
bayonetez	baionetez
dis	dis
Apostat	apostat
koedkroez	koadkroaz
penngoulou	penngoulo
ridet	riv
inou	eno
ergurentage	kerentaj
gwallberiou	gwallober
vammmager	mammvager
ergadorpredg	kadorbrezeg
recevour	resever
difreio	difreio
roltet	roltet
afa	afas
aretorn	retorn
discalonc	diskalonek
blankik	blank
dizaoured	disaouret
coalgundu	gwallgundu
penkonz	pennkomz
peklienn	pikolenn
agatar	katara
abenfinandro	abennfinandro
silaouret	soulaouret
dornhibill	dornibil
goanvn	goavhav
spled	spled
chagrinet	chagrinet
wanderiou	gwander
arebele	rebellarebelli
redadec	redadeg
erhaijaj	kejaj
zigor	digor
reigolo	rei
porsguint	porzhgwint
ecreiztre	ekreizetreekreiztre
irbaillardigueah	pailhardigezh
Eurgokoen	kokoenn
magasinet	magazenna
ruzven	ruzwenn
tremeniat	tremeniad
Blaouahet	braouac'het
lorhet	lorc'halorc'hi
Diboell	diboell
kannadeg	kannadeg
enemro	rei
eurc'hravasdoug	kravazhdoug
kliked	kliked
filout	filout
lanfoet	leunfoet
daou	daoubleget
etivuanekeont	divuanekaat
skodou	skod
leuren	leurenn
astoccroc'hen	astokkroc'hen
drejo	tres
dallput	dallput
plousegou	plouzeg
carnet	karnet
Idoltriachidolitriach	idolatriajidolatriezh
senthus	sentus
azprena	asprena
nesiket	sia
freuza	freuzafreuziatfreuzi
vlas	blaz
SantVaze	SantVazhePennarBed
avan	aveiaven
beurnetaat	peurnaetaat
p'eguir	peogwir
vlutach	flutaj
morgenn	morgenn
bostadet	bostadet
effejou	efed
stourmad	stourmad
Blennvez	bleuvnevez
feillad	feilhad
teissr	teiser
sklabezadurez	stlabezadurezh
zouarenn	douarenn
digor	digor
hadretorn	adretorn
clanveet	klavaet
adaill	adailh
horel	horell
camed	kammed
h'lommer	koulomer
barbelec	barbellek
ecreizetrezo	ekreizetreekreiztre
difrink	difrink
penpill	pennpilh
adrspar	adreistpar
er	er
mourailleu	morailh
dihouriadet	diwriziadi
fleureji	fleureuji
arc'hedez	kedez
lardkuill	lartkuilh
loadet	louadi
douartirien	douartirien
askuize	skuizha
bekfuzil	begfuzuilh
idolatriaz	idolatriajidolatriezh
libertin	libertin
varilliad	barilhad
dic'hloar	dic'hloar
Perdebrei	peurzebri
hentchoutro	henttro
dizispign	dizispign
displica	displika
didach	didach
eurc'houplad	koublad
instrujet	instrujet
pizhapiz	pizhhapizh
aziellaz	siellasielli
dizunvan	dizunvan
merc'hejoufall	merc'hfall
setuaman	setu
ergentaou	ergentaou
dic'hoantegez	dic'hoantegezh
hented	hented
o	blod
zinec'hi	dinec'hi
da	rei
lizerekeet	lizherekaat
Agordennadou	kordennad
Direngennet	dirajennet
mouskin	mouskin
perier	perier
brec'hdu	brec'hzu
aoglenn	oglenn
peurgreaat	peurgrevaat
crehenet	kreienet
pennaraog	pennaraog
ne	ne
abebquis	abepgiz
Hevelmil	mil
wellgann	gwallganna
sammuz	sammus
ami	ami
Kost	kost
prst	prest
theologal	teologal
vlistreresdour	flistrerezdour
brignene	brignenennbrignonenn
fidlit	fidelite
diroufennit	diroufenna
beleiendouet	touet
taulsl	taolsell
ollvadelezuz	hollvadelezhus
darnet	darnet
huiezegasschongeteign	degasdegasi
castis	kastiz
riscuz	riskus
aenkrezjomp	enkrezi
enhormesko	emesk
divot	divot
nisbihan	nizbihan
exprimidiguez	eksprimidigezh
Goedennek	goedennek
kerronnet	kerc'honet
abeurlaz	peurlazha
difinves	difinvezh
dic'hout	dic'hout
lachentez	lachentez
dinaturi	dinaturadinaturi
schoni	skuizhoni
tarigoz	tarigoz
eurc'hlanvour	klavour
divoc'h	boc'h
nehuhan	nevezhav
Goge	goge
fontbadisiant	fontbadeziant
koumpagnunez	kompagnunezh
dishanuettan	dizanavet
gniegour	gwiniegour
bernvarvern	bernwarvern
bremak	bremaik
arbladenvene	pladennvenez
garc'heiz	kerc'heiz
psalmeri	psalmeri
anemised	anemiz
Digompez	digompez
dizharp	disharp
lichichen	lichichen
taolru	taolru
huibeden	c'hwibedenn
diozet	diaozet
istre	estre
kuitaatarbekdouarman	begdouar
boedenhelost	bouedennlost
abadma	abad
dibarquein	dibarki
salissa	salisa
Sourina	sourina
digopet	digoupet
truillenneg	truilhennek
ayouancq	ayaouank
moucht	mouched
croza	krozalkroza
Direktoer	direktoer
kargour	kargour
groahenn	gwrac'henn
enememmelleus	emelloutemella
placet	plaset
incomprenabl	inkomprenapl
Kryou	ker
potrkeguiner	paotrkeginer
pars	pares
von	von
Heal	hael
leunc'hoad	leunwad
fringellat	fringellat
Lenn	lenn
eurc'holetaro	koletarv
ali	ali
sutryen	suter
obereundommadenn	tommadenn
neket	neket
neket	neket
iaouBask	YaouBaskYaouFask
dregreiz	dregreiz
gwinizgou	gwinizheg
skouarned	skouarnet
fondzon	fondezonfondezion
agripisse	kripisa
zularPusdibus	peuzdibeuz
mezepet	mezepet
anvoezen	havouezenn
ster	str
Gourlerc'her	goulerc'her
breinoni	breinoni
meancorn	maenkorn
examplus	egzamplus
Annoc'haned	hoc'haned
discred	diskred
azigouezaz	digouezha
ahantr	ahanter
moritelhat	moritellat
neiziaoui	neizhiaoua
red	red
teurc'huezet	torc'hwezet
blach	blach
oulm	oulm
eu	oes
gomor	govor
zac'ha	sac'ha
treuzdidreuzdeh	treuzdidreuz
bassefos	basefos
rudizec	rudizeg
agordennadou	kordennad
karnet	karnet
vaillurenna	mailhurenna
dvorant	devorant
hirnes	hirnezh
azivarbouez	aziwarbouez
Enqueithama	ekeit
lonkrez	lonkerezh
vezia	bezia
ayouancq	ayaouank
dic'hoarz	dic'hoarzh
enemanaout	anavezoutanavoutanaout
c'hwiltouzien	c'hwiltouz
distrafuillet	distrafuilhet
kochonnet	kochon
arc'hrouffograou	koufrograo
derveziad	devezhiad
Fustmust	fustmust
tadkozargaou	Tadkozhargaou
beugisal	beugisal
ivanti	invanti
bodennet	bodennet
jaugeaplan	jaojapl
brizdescadurez	brizhdeskadurezh
warhentenn	wareeuntenn
lovrereah	lovrerezh
faosoniou	faosoni
SantVazePennarbed	SantVazhePennarBed
huilcrugud	c'hwilkrug
pitach	pitach
didortil	didortilh
koedhaleg	koadhaleg
Abepamzer	amzer
Kadorarbinijen	pinijenn
peurwriet	peurwriat
dizakr	disakr
ollc'halloudek	hollc'halloudeg
lerc'hlerc'h	lerc'hlerc'h
deputeed	depute
imparfall	amparfal
draillkorf	drailhkorf
stuyou	stuc'h
marc'hjervich	marc'hservij
louaret	louaret
skanbennet	skavbennet
amzigor	amzigor
roqueden	rokedenn
pennoukenta	pennkenta
peurc'hreat	peurc'hraet
derven	dervenn
Kerezek	kerezeg
discuilldioc'h	diskuilh
meret	meret
Kuitouz	kuitouz
tytavarn	titavarn
napegeit	pegeit
asmir	azmir
teurgellek	teurbelek
saour	saour
sauzon	saozon
itic	itik
divisctog	diwisktog
frigaset	frigaset
hebrn	heizbrenn
Mouchenn	mouchenn
chalquet	chalket
rangalon	ranngalon
diferm	difeurm
krenvan	krenvan
fuzulien	fuzuilhenn
touelluz	touellus
penndibenn	penndibenn
brumennet	brumennet
ganneresns	kannereznoz
engherz	engerzh
abad	abad
Reogwenn	revgwenn
haderez	haderez
avoalstag	gwallstaga
usmolet	usmolet
goarm	gwaremm
cousemennet	kouzoumenni
gogeal	gogealgogeagogei
al	all
urhabuchon	kabuchon
aribl	aribl
peurvaro	peurvarv
goarnation	gouarnasion
testeu	test
avad	avat
dibermet	dibermet
mouchette	mouched
disuport	disuport
turierdouar	turierdouar
begad	begad
muntrereset	muntrerez
awezannamzer	awezh
etloevrall	brall
victim	viktim
Bothsorel	Bodsorc'hel
grizillonit	brizilhonibrizilhona
amgristen	amgristen
dispostioneu	dispozision
Tabernacl	tabernakl
zznach	saoznaj
shet	sec'het
avad	avat
gourdrouzou	gourdrouz
dis'hlac'har	disc'hlac'har
gulator	kulator
estlammet	estlammet
fontan	fontafonti
korgamek	gourgammek
apoeilhou	apoueilh
paan	paian
trabellerez	trabellerezh
kistenmoc'h	kistinmoc'h
modigansou	modigaso
Varevelse	warevelse
diveleien	diveleg
Botezlouz	botezlous
wardaro	warzarev
vraventez	braventez
dic'hoanteghez	dic'hoantegezh
elfen	elfenndan
romen	romen
dilivrans	dilivras
fleurenned	fleurennet
dic'hout	dic'hout
toneu	ton
diamzavet	dianzavet
Spot	spont
assolet	asoli
zauzein	saoza
ollbaduz	hollbadus
azvelet	azgweloutazgwelet
adroetro	adroetro
pegwir	peogwir
etiflistraz	deflistra
eurgontadel	kontadell
driouac'hed	triwec'hvet
diflat	diflatrdiflat
prestou	prest
dihouriadein	diwriziadi
Filsierauten	falzaotenn
prouf	prou
kazgleb	kazhgleb
vtet	vatet
tadargaou	tadargaouargevier
ampouisonour	ampoezoner
scrignadll	skrignadell
Kamlez	Kamlez
sacr	sakr
Tuaillnnneu	toailhenn
recorded	rekord
perlez	loupenn
skuiza	skuizha
tragidi	trajidi
arc'haniennou	kanienn
loskus	loskus
peurdispin	peurzispign
avamen	avama
traouesiou	traouezio
zama	zama
gihue	gwiv
Linegez	linegez
amnoh	amen
spouronnuz	spouronus
erc'hornpleg	kornpleg
bali	bali
arVourc'hvenn	Bourc'hWenn
Roskoaden	Roskoadenn
Sklipad	sklipad
perdroed	peurdrei
Peuzdibeuz	peuzdibeuz
agarradeu	agarrado
derc'hentdeac'h	derc'hentdec'h
oredas	oredi
nadroughanvalketouz	droukhavalout
treuzet	treuzitreuza
dasse	dase
deurbihue	dourbev
mestrezplac'h	mestrezplac'h
zivisctog	diwisktog
primhaprim	primhaprim
andrabel	trabell
dic'houibu	dic'hwibu
diveramzer	diverramzer
besiadou	beziad
guall	gwall
onda	didu
diroll	diroll
nandecvd	naontekvet
azismeghint	dismega
yerdour	yarzour
diweskelleg	divaskellek
c'hoariellachou	c'hoariellajo
achorme	chormi
Gunizegou	gwinizheg
odeougarr	odegarr
disterved	disterved
prizachet	prizajet
neusdet	neuzded
azindanguz	azindanguzh
gommancc	agomas
keuren	keurenn
dadouez	dadouez
divroad	divroat
chouis	chouis
avalouoranjez	avalorajez
dilivran	dilivras
Toullbez	toullbez
diblas	diblas
Dastaz	dastaz
tibordel	dibordal
goudouren	goudorenn
abersonjas	peursojal
kouetis	kouetiz
Goden	goedenn
hochon	kochon
argalonlaz	kalonlazh
marveillus	marvailhus
Arab	arab
poud	pout
bremadiveza	bremadiwezha
kammed	kammed
Gorlei	Korlei
alanaddiveza	analad
emetiq	emetik
Mardozi	mardozi
opium	opiom
lunedennou	lunedenn
tisabuzi	dizabuzi
ostenminiq	ostant
simpad	simpat
diventur	diventur
blas	blaz
reneein	renevezi
forbanet	forbannet
d'nou	eno
sigur	esigur
trubarderez	trubarderezh
divuzuz	divuzus
arbevaret	pevaret
etrufflint	trufla
gallek	galleg
diamen	diamen
edguenn	edgwenn
zoken	siken
hedholanchen	lachenn
enomesk(o)	emesk
distagerien	distager
Hoadgoez	gouez
didok	didog
Bvinsazon	saesonsaezon
esperjein	asperjaasperji
C'hoarleaz	c'hoarlaezh
beillerez	beilherezh
peurrest	peurrest
accompagnunecat	akompagnunekaat
aziriklas	dirikla
taolru	taolru
rost	rost
dibistig	dibistig
bibis	bibisbibisig
plean	plaen
endribunal	tribunal
beizik	beizik
Anaoudek	anaoudeg
lardislar	lavardislavar
emganna	emgannaemganni
meahus	mezvus
enemdizinoui	dizenoei
zomuiken	zomuiken
mudet	mudet
potbassin	podbasin
tauxeu	taos
dinec'hi	dinec'hi
goalgundu	gwallgundu
gleuat	gloevaat
gouanderiou	gwander
Guedour	gedour
reoll	reholl
stouet	stouet
corcqed	kork
areazlammchoukhebenn	lammchoukebenn
dizanaoudek	dizanaoudek
difrouezidigez	difrouezhidigezh
Uzel	Uzel
ifirm	ifirm
Diasavet	dianzavet
Parbleur	parbleur
gouremou	gourem
toulbouger	bougre
azoebatdezo	ebat
scosselus	skosellus
urouilliaden	goueliadenn
douj	douj
c'harlatanet	c'harlatanet
limet	limet
aziadr	aziadro
stalage	staliajstalaj
Falhvarchecheu	falsvarch
droukimplia	drougimplijout
androzanc	trozas
Lammout	lammatlammetlammoutlammilampatlampout
adudedu	adudadu
pilejou	piled
