amzeri	amzeri
arspered	berrentez
taraser	taraser
bankerien	bankerbankour
aetdigadao	digadao
Hollvestroni	hollvestroni
Dispounta	dispontidisponta
astrimp	astrimp
potour	potour
kaolbrokoli	kaolbrokoli
ruzvelen	ruzvelen
gouelst	gouelstae
kinteennan	kinte
vareaj	mareaj
avaloupechez	avalpechez
luduc'hoalen	luduholen
dreistgor	govor
taoliata	taoliata
poezahagaspoeza	aspoueza
eurhorndero	kornderv
Koutia	koutia
erhatat	ervataat
lentidigez	lentidigezh
Dijenoc'h	dijen
eurc'hac'hmouden	moudenn
Polonia	Polonia
Reveulzi	reveulzi
izelved	izelved
divrud	divrud
korbigenn	korbigenn
laviga	lavigalavigat
didou	didou
kasade	kasade
broenneg	broeneg
amzer	amzer
ou	bloukard
gwidal	gwidal
Glanyezhourien	glanyezhour
arGloria	gloria
staldiegezh	staldiegezh
ied	sablienn
baskein	baskein
Nondedyah	nondediac'h
bonjouri	bojouri
dinanet	dinaonet
marc'hnaer	marc'haer
boulltenn	boultenn
ergordennad	kordennad
argarvanlien	karvanlien
falzkreden	falskredenn
hwiledSantYann	c'hwilsantYann
vag	mag
affuret	afuret
bouedhanv	bouedhav
emzikour	emsikour
peurgloza	peurgloza
chao	chav
tadabad	tadabad
Spleda	spleda
paotrarc'hilkrog	kilkrog
tastoni	dastoni
faro	faro
skanbennet	skavbennet
tuda	tuda
erc'hskorn	erc'hskorn
broein	broabroiabroi
bastellen	pastellenn
voret	eoreteoriet
forbanet	forbannet
pourmenet	pourmenpourmeni
lustrugen	lustrugenn
rastelldoull	rastelldoull
en	amzer
agildro	agildro
marvad	moarvat
n'ouzondare	dare
Bonjouri	bojouri
weliena	gweliena
dregreiz	dregreiz
baldol	dol
veri	merameri
golernein	gwalarni
feblentez	feblentez
flepa	flepaflepatflepi
lagout	lagout
ec'houelmiklez	gouelMikaelez
bouederc'h	bouederc'h
Kofostamm	kofstamm
andlter	aoter
chinkgoloen	chikolodenn
flip	flip
diboret	diboreet
fonsier	fosier
erc'hofituriou	kofitur
demnoblanz	damnoblas
hoffblo	koefblev
koc'hbleiz	kaoc'hbleiz
skrignet	skrignet
fubumoui	moui
Soterez	soterezh
muiohpemui	muioc'hpevui
teltet	telti
jaujapl	jaojapl
bourus	bourrus
edoulad	toulladi
abelldro	abelldro
saldibri	saldebri
'noaparti	parti
umvobionat	bobionat
tredan	tredan
fiskoaniet	fiskoania
stouvell	stouvell
poupig	poupig
Falimpl	fallimplij
Eurvenajereztaol	menajereztaol
stennstegn	stign
dihiliet	dihiliet
koletenn	koletenn
Kerien	Kerrien
rastelldoenn	rastelldoenn
harrikotal	harikotal
kiza	kizakizi
dirange	diraj
warhokorre	gorre
marhlevr	marc'hlevr
ergadorpredeg	kadorbrezeg
mammougoz	mammgozh
Unaniez	unaniezh
malizennou	malizenn
arspount	spont
aredare	aredare
c'hourlerikat	goulerc'hikat
arteziad	arteziat
trederann	trederenn
direlijion	direlijion
dichleu	diselaou
Bilost	belost
raadur	raiadur
garnubet	garenebi
dizouar	dizouar
Foran	foran
lagoutat	lagouta
Salan	Salaun
guindas	gwindask
istrevijiri	estrebedestreved
Nonndezhi	nonn
Puff	puf
pastellenneu	pastellenn
lartpik	lartpik
termajiou	termaji
piltoz	piltos
mastourennet	mastarennet
espermette	spurmanti
lip	lip
Koagat	koagalkoagatkoaga
dantmarc'h	dantmarc'h
foulia	fouliav
divoull	divoull
arC'hapetinad	kapetinad
dilabour	dilabour
eunhagen	eeunhageeun
minet	minet
framasonek	framasonek
dak	dak
avozadou	avozado
reiz	reizh
mahet	mac'het
monedone	monedone
fabota	farbota
Daon	daon
Gwalleruzamant	gwalleruzamant
revor	revor
gaouiet	gaouiagaouial
diskalon	diskalon
rudagn	rugagn
abilpazig	abilpazig
nedinteger	tintaltinta
shour	sec'hor
muchamurcha	muchamuchi
divourdein	divourdi
skism	skism
tres	tres
hetein	hetaatheti
digomz	digomz
bouilha	bouilhabouilhi
tidanrieu	didaner
boukidipenndu	bokedpenndu
dilodennus	dilodennus
Streubeul	streuvell
avat	avat
ayunas	yunayuniyun
gwerbilh	gwerbilh
aziarskan	azirskav
kilbleg	kilbleg
fourrat	fourrad
laezmesk	mesk
adreuzdidreuz	treuzididreuzi
evitoare	evitdoare
brein	brein
tamall	tamall
Boudet	boudet
avremenik	avremanik
TadouGwenn	tadgwenn
bichibonig	bichibonig
livitennet	levitennet
erion	esaeer
titich	titich
tizelita	dizelita
tremeniad	tremeniad
bohonereh	poc'honerezh
enemberskekut	persekuti
stigngwele	stigngwele
labourerporz	labourerporzh
evelkenthagoude	evelkentevelkent
eurwizad	gwiziadgwizad
diaket	diaket
Dilzvam	dilezvamm
melei	melameli
lufrd'	lufr
diharak	diharak
pemoc'hgouez	pemoc'hgouez
eskobet	eskobi
ainou	aeno
lerion	diorbler
urgludenn	kludenn
Saperlotez	saperlotez
sorennet	sorennet
Aneubeuddaneubeud	anebeutdanebeut
dibunadeg	dibunadeg
dibrez	dibez
aksour	akesour
groz	gros
libell	libell
abennnemeurama	abennnemeur
eurbaldol	dol
Frlom	frelom
adklevet	adklevout
fringol	fringol
brochen	brochenn
Japan	Japan
arbrofetez	profedezprofetez
ravolt	ravolt
pillotour	pilhoter
diouan	diwan
chourikereh	chourikerezh
buanhabuan	buanhabuan
tremenidi	tremeniad
Frai	frai
Klor	kloer
sked	sked
bodarbitoun	biton
cheuc'h	cheuc'h
klevet	goulenn
Dibreveda	dibreveda
Mardoustik	mardoustik
rakporzh	rakporzh
sked	sked
peurbeoc'h	peurbeoc'h
vombardi	bombardi
leonat	leonat
vushoarheindohti	mousc'hoarzhin
Egintaou	ergentaou
adkompouezet	adkompezet
EntarGroaz	kroaz
ribitailhad	ribitailhad
douiged	doueig
angli	angli
divlas	divlaz
ese	ese
eu	bannneud
Cheche	cheche
dic'houlou	dic'houlo
skrignereh	skrignerezh
haghen	hage
agetan	agenta
Cheuc'h	cheuc'h
eoliet	eouliet
termona	termona
tigortoz	tigortoz
joeiseinag	jouisajouisi
lizerMeur	lizhermeur
aotervraz	aoter
Felloutarad'in	fellelfelloutfallout
plein	plaen
tana	tana
rebutet	reputareputi
zivrezounek	divrezhoneg
oberandizerc'h	dizerc'h
eurbegad	begad
moret	moret
BadeziantanDrovan	trovan
voterien	voter
loanbleugn	blein
vegelgouch	begelkouch
diveborein	diveboari
distilhour	distilher
pato	pato
sperneg	sperneg
Mik	mik
pennsturier	pennsturier
heusen	heusenn
Suilha	suilhasuilhi
adouilhan	adouilha
Millig	millig
adpobladur	adpobladur
voterien	voter
pileubeg	pilbeg
neptueg	neptueg
adkempen	adkempenn
mel	mell
pln	plaen
gaboreu	gaboro
spleitabl	spletapl
warbres	warbrez
Drr	drr
Kremilborgnon	borgnon
lagout	lagout
stignet	stignet
douarenn	douarenn
Bokedenn	bokedenn
arGambrgenwerz	kambrgenwerzh
Duot	Duaod
azourc'houez	dourc'hwezha
c'heneskob	keneskob
minafel	maenafell
deur	deuc'h
dijastreoc'h	dichastre
tommhatomm	tommhatomm
stoupmor	stoubmor
warzirabas	dirabas
erhupad	kupad
htatarhlerh	hetaatheti
dousikat	dousikaat
bezindizol	bezhindisol
hollvadelez	hollvadelezh
talabardi	talabardi
brozhiodanbrezhierdan	brozhdan
mailhemouzet	mailhemouzet
diframm	diframm
freseli	freselatfreseli
terzienngrin	terzhienngrin
farbouchat	farbouchat
Disklavet	disglavet
arbreferans	preferas
vaksinet	vaksinet
goalhent	gwallhent
delienenn	delienenn
banktosel	tosel
chetal	mut
Gourland	Gourlann
digripon	digripon
Kanikennat	kanikennat
eazouny	aezoni
katekiza	katekizakatekizat
peurc'houzout	peurc'houzout
erc'hilutig	kilutig
alorc'h	alorc'h
dekwa	dekoa
furchalhadifurchal	difurchal
aharpazoutho	harpaharpi
paraplu	paraplu
beurdresan	peurzresa
d'arfourch	fourch
riderionbro	rederbro
polz	polez
gwinpalmez	gwinpalmez
adroh	adroc'h
Sohetoh	souezhet
andriaden	triadenn
eurglemmusken	klemmuskenn
Pevarlammat	pevarlammatpevarlammi
milon	milon
war	brall
Sumudi	sumudi
termaji	termaji
pegoulz	pegoulz
ziouvoc'h	boc'h
artizaniez	artizaniezh
dizall	dizall
Kliked	kliked
doen	pinijenn
luzern	luzern
drouget	drouget
mouk	mouk
Adaolkrenn	adaolkrenn
pe	pe
digig	digig
odivi	odivi
milvouezieg	milvouezhiek
brein	brein
zec'hor	sec'hor
chipotereh	chipoterezh
efilbichas	filbicha
ArC'Hloastr	KloastrPlourin
damedomre	damedomere
urharhad	garzhadgarzhiad
Kerne	KernevKerne
damhir	damhir
ekwit	ekuit
Daonik	daonik
hoantuzenni	c'hoantuzenni
Addibuni	addibuni
doleranz	toleras
SantPever	SantPever
amodel	amoedell
choberd	choberd
chemp	chemp
rouzig	rouzig
etremek	tramek
Taliog	taliek
jscrimou	iskrim
folklorachi	folkloraji
sklosennek	sklosennek
krikal	krikal
arc'hult	kult
Eurc'harteurvez	kardeurvezh
poentennet	poentennet
enemdana	tana
arhravazkamm	kravazhkamm
adkanan	adkana
stammiou	stammio
lorc'ha	lorc'halorc'hi
Takebier	takebier
skolgwenana	gwenana
tartouz	tartouz
pastellek	pastellek
poanbleo	poanvlev
Tokennet	togenni
Keltiek	keltiekkeltek
oberdiaesd'eza	diaez
raorao	rao
urouiliaden	goueliadenn
umdorchennein	torchenni
ekonomikel	ekonomikel
diezomm	diezhomm
douitouial	touitouial
aparans	aparas
Dihoapeit	dic'hoapaat
dreistoll	dreistholl
Dich	dich
maplomeo	plomea
matmatigeu	matematigo
ehanarvest	ehanarvest
harpaouz	harpaharpi
feilhasken	peilhastenn
urvouzarenn	bouzarenn
stroallek	stroallek
wigour	gwigour
hirellek	hirellek
tenneris	tenneris
aveet	aveiaven
bezakerzetgantoholl	kerzet
nionk	nionk
maredavare	maredavare
feitanz	fentas
laouenamant	laouenamant
talocha	talocha
bazennbazinier	bazenn
redernoz	redernoz
chargregoj	chargregoj
disas	disas
intanereh	entanerezh
chaokerehenou	chaokerec'heno
kendijenatra	dijen
frikoupaea	frikopaea
libistret	libistret
peurzistaga	peurzistaga
kansel	kasell
pln	plaen
amodll	amoedell
nivlennouoabl	nivlennoabl
tourket	tourked
dalour	daleer
pennboemet	pennboemet
brizamzer	brizhamzer
magnous	magnous
hirlaten	hirlatenn
Bribouilh	bribouilh
dilemma	dilemma
distripa	disklipa
flaket	flaket
vombezenna	bombezenna
SanteKroaz	Santekroe
kloriet	kloriet
digasdignva	skiantvat
torgennek	torgennek
tellodeved	telldeved
kilienni	kilienni
beteghen	betekhenn
dihlan	dic'hlan
ebad	ebat
beobuez	bevbuhez
volarjesa	meurlarjezameurlarjezi
dantier	dantier
barrikad	barrikad
aramadur	armadur
flepat	flepaflepatflepi
andoniet	andoniet
kraodimezell	kraodimezell
simoul	semoul
diharak	diharak
dramegnan	dramignan
langour	langour
aezetaat	aezetaat
StadouUnanet	StadoUnanet
haikal	haikal
garved	garved
patateza	patatesa
lipad	lipad
armead	armead
alazike	laziga
boslagout	lagout
Dic'hodellet	dic'hodella
ahetet	ahedet
rabadyezou	rabadiezh
astellgrampouez	astellgrampouezh
pennkamm	pennkamm
harpon	harpon
kannaden	kannadenn
jiblek	jimblek
deruad	dervad
Gerz	gerz
zisulran	disoliera
ahentall	ahendall
c'harennskoaz	karennskoaz
garaned	garanagarani
'nemdispountan	dispontidisponta
polui	poluapolui
Guipronvel	Gwiprovel
dea	deuv
hedet	heda
tizurzi	dizurzhi
renabl	renapl
taoliokoufr	taolgoufr
skingas	skingas
fekul	fekul
Laouitouz	laouitouz
c'hailhosat	gailhosat
Diziwez	diziwezh
vizeal	bizeal
siriusoc'h	sirius
goledQerne	KernevKerne
'wechadiaou	awechadigo
bitraki	bitraki
arBater	pater
peurbare	peurbare
tilabour	tilabour
orc'hac'halanig	kac'halanig
boutgoapgetou	goap
evnedyer	evnyer
Bakus	bakus
landure	landure
pididip	pididip
abennhent	hent
karrezennwar	karrezennwar
terderann	trederenn
flutigeu	flutigo
Rebechat	rebechrebechirebechat
urbeponel	peponell
gwaze	gwaze
Akre	akre
tifetein	difeti
zaonn	saon
tifoac'ha	difoac'ha
Sourvomet	soulvoemet
stiraj	stiraj
hoalgasereh	gwallgaserezh
tidorchennein	didorchenna
jagudet	jagudet
gwallskoueriet	gwallskoueria
Libell	libell
avgad	begad
ed	pelon
amzouri	amzouri
warrg	warraok
ez	ez
ankenius	ankeniusankenus
warantrimarezan	trimard
disscarerion	diskarer
haulatereh	heolataerezh
lac'hdi	lazhdi
enemizelaat	izelaat
ravolt	ravolt
sinaek	sinaek
guetis	getiz
Tunizi	Tunizi
tavin	tavin
difeiz	difeiz
Sorc'hennou	digredenn
Mardousien	mardousien
broc'hadeg	broc'hadeg
Aouaouaou	aou
amphiteatr	amfiteatr
indervez	endervezh
bagerien	bageer
uzachet	uzajet
Badouelletbaduellet	baduellet
gwezpabu	gwezbabu
silis	silis
eurvrochennad	brochennad
pennasket	pennaska
agrogilin	agrogilin
miget	miget
nouch	nouch
a	gwall
paradaouf	paradaouf
aveinaven	aveiaven
glizetez	glizhetez
digaraj	digarezaj
trepet	trepet
gragachat	gragachatgragachi
Arc'holler	koller
forlinkat	forlinkat
chao	chav
Fed'amdouac'h	fedamdouac'h
varentenn	wareeuntenn
panarbec'h	panerbec'h
andoniet	andoniet
kolladennet	kolladenni
geomoarvat	moarvat
pedgouls	koulz
leurennoukar	leurenngr
entanet	entanet
vrigouillad	brigouilhat
pecherou	pechero
naet	navet
tribunale	tribunaletribunalek
azianeor	azindanevor
Rukunet	rukunet
Brastroet	brastroet
pisskangr	pis
divalvenni	divalvenni
pirc'hirinaj	pirc'hirinaj
taoldigor	taoldigeri
tavoulek	tavoulek
o	bob
arc'hazetennerien	kazetennerkazetennour
melanijet	melanijet
riolenkar	riolenn
enkroug	ekroug
difurchet	difurchal
gomeriaji	komeriaji
sorseddeur	sorsdour
lizermeur	lizhermeur
pennPaourig	pennpaolig
alc'houederedtraez	alc'hwedertraezh
Targouilh	targouilh
fedadouac'h	fedadouac'h
daoubleged	daoubleget
staliata	staliata
arc'hlapezenn	klapezenn
lazioukanan	lazkana
arabek	arabeg
petoh	paeet
arabadus	arabadus
tigarezioki	digarezki
tioha	dihoa
abichotas	pichota
tismantri	dismantradismantridismantr
aoglein	ogli
Cousqers	kouskerez
bourra	bourra
stokenn	stokenn
Himchiffein	chifachifalchifi
pouloudek	pouloudek
ziplomatelezh	diplomatelezh
lostennek	lostennek
moust	moust
eundigredenn	digredenn
mourouzeion	mourouzeg
brhard	brec'hard
arc'hlazenen	glazenenn
komersat	komersikomersat
urhohltar	koletarv
paperhent	paperhent
rannet	rannet
eilkenta	eilkenta
ahedkalz	ahedkalz
gouegerh	gouegerc'h
opato	patoenn
arvangrovenn	mangrovenn
touerien	touer
toferez	dozverez
kac'hpod	kazhpod
macorzennont	korzennakorzenni
praj	peuraj
didoull	didoull
kaoc'haj	kaoc'haj
mitio	mitio
ahetet	ahedet
diskrougnet	diskrognet
dourbrein	brein
kabellbadez	kabellbadez
jabotrujabouru	jabodruz
ner	ner
Newentiz	nevezinti
Ezet	aezet
bousken	bouskenn
saherien	sac'herienn
spurmantet	spurmanti
dilauskdilauskein	dileuskel
mellad	mellad
azibouez	azibouez
gorreDoue	gorreDoue
Cherreinehraunhuizaden	c'hwezadenn
tuzumoktuzumek	tuzumek
ien	gazer
lostpik	lostpik
kilbenn	kilbenn
ruillennok	ruilhennek
satinet	satinet
diaboeisans	diobeisas
aziabars	aziabarzh
d'erpearlam	pevarlamm
ijinusted	ijinusted
zic'hlac'hari	dic'hlac'hari
Huelgoadiz	Uhelgoadiz
zeitekved	seitekvet
Ich'ta	ichtich'ta
gwerc'hlas	gwerc'hlas
skora	skora
dreistholl	dreistholl
zivrezonega	divrezhonega
chakod	chakot
breugadennou	breugadenn
diskontro	diskorntro
tolpet	tolpet
sulirad	solierad
dadarpec'hed	tadarpec'hed
Macheriou	macherio
chaogat	chaokatchaokachaoki
dizalbad	dizalbad
dierhezein	diwerc'hezi
skrangnet	skragnet
dirent	dirent
cheta	cheta
dirabas	dirabas
erc'hlouar	klouar
lavarethagaslavaret	azlavarout
gleupaj	gleupaj
tapado	tapad
Deiziadur	deiziadur
gerz	gerz
chijarnet	chijarnet
flanketat	flanketat
bauchal	baochal
ofiskav	ofiskav
gwelemein	gwelemein
didortilh	didortilh
menpar	maenpar
aziabarh	aziabarzh
bolitikel	politikel
adostberr	adostberr
dizellez	dizellez
genlabourer	kenlabourer
avuzulma	muzul
helpenn	helpennhelpenni
afourch	fourch
pitra	pitra
aflao	flav
hualadur	hualadur
umziboniein	diboaniadiboanii
drezirak	drezirak
krampouezennzu	krampouezhenn
struda	struda
enevizou	miz
diempennet	diempennet
dispounta	dispontidisponta
pilad	piladdour
ekokoge	kokogi
dihompret	diempret
huzerion	c'hwezer
touerez	touerezh
tirivilatdoht	direvilatdirivilat
emrenerez	emrenerezh
digoumoul	digoumoul
matematigeu	matematigo
Dama	dama
imurein	imori
kengavo	kengav
arc'hefiougwini	kefgwini
nouch	nouch
Kaoutpennbrec'h	pennbrec'h
per	per
Chichantaet	sichantaat
arc'houskae	kouskaez
fouilh	fouilh
akustum	akustum
ruilladenn	ruilhadenn
dreistnatur	dreistnatur
neudet	neudet
bura	pura
gwadigellet	gwadigellet
bodadbouidad	bouedad
euntaolchao	chav
marehamare	marehamare
Kaerder	kaerder
leurenn	leurenn
Obizidi	bizidi
gwiber	gwiver
tiruskennein	diruskenna
tolstrap	taolstrap
Dirodein	dirodi
phhoari	pezhc'hoari
logn	logn
rederbro	rederbro
azindanzivin	azindanzivin
Krampouezhlogod	krampouezhlogod
bouzarus	bouzarus
koadbuch	buch
fic'hellerez	fic'hellerezh
didalbennet	didalbennet
azoandonietmad	andoniet
bensezi	pesezi
diranj	diraj
sperejoudebret	debret
adren	adren
lestrbrezel	lestrbrezel
dezournet	dezorna
enememmelda	emelloutemella
ragistorvezad	ragistorvezhiad
c'hrosaat	grosaat
entreeno	eno
stter	staoter
siellet	siellasielli
kuzuliad	kuzuliad
koant	koant
yac'hdadibistik	dibistig
ruzellvintin	ruzellvintin
avaloutaol	avaltaol
avanturet	avanturi
nehanterlaboureket	hanterlabourat
dizursiou	dizurzh
lug	lug
Mikael	Mikael
Matareg	matareg
kuanhudrek	kuanhudrek
Famin	famin
urbam	bam
rivet	rivet
akours	akours
ridellit	ridellat
menaodryen	minaoueder
dizale	dizale
nevketmangrelletspered	magrellet
artelein	arteli
verc'herarpuzlard	peuzlard
bouedmir	bouedmir
trankil	trankil
dapet	tapet
perloat	berloat
chalboter	chalboter
kordennadou	kordennad
Lurell	lurell
Filopenn	filopenn
glaougan	glaougan
glapezennou	klapezenn
harta	harta
adostiktra	adostiktra
sohellat	soc'hellat
vagacha	bagaja
poloniat	poloniat
foeltrizion	foeltrizion
argalc'hudenn	kalc'hudenn
c'hravia	gravia
gan	gan
azoskoretwar	skoret
Gorbenn	gorvenngorbenn
tres	tres
dispountet	dispontet
para	para
Adkeltiekaat	adkeltiekaat
drailh	drailh
ziella	siellasielli
vinvaden	fivadenn
geuiardein	gaouiardi
bernmor	bernmor
aboell	aboell
arvoulj	rvoulj
kannadigou	kannadig
relijiel	relijiel
chs	chas
frhegi	frouezheg
azeeh	azevezh
digargusennein	digargusenni
agroane	kroanal
zigolia	digolia
goudor	goudor
skolachou	skolaj
monandeu	monando
riou	riv
lursterling	sterling
'fat	avat
strincqellryen	strinkeller
skedus	skedus
elkent	evelkentevelkent
lampantoun	lampanton
diskardeliou	diskardelio
chupennet	chupennet
gadoreskob	kadoreskob
ion	levroniour
trkaer	trekaer
blchat	blechat
Erhasourlihrieu	kaserlizhero
nebaunik	nebaon
verzerenti	merzherinti
paournoaz	paournoazh
amzerus	amzerus
Hanokadarn	anvkadarn
trucha	trucha
gorklun	kornklun
o	kub
eroahval	gwazhval
siroso	siros
difoesket	difoesket
rikamana	rikamana
tolpez	tolpez
rchet	rechet
zidorta	didorta
azindanenvor	azindanevor
prchas	perchas
argoadiz	argoadad
kilbenni	kilbenni
segalenn	segalenn
c'hoalenet	holenet
garennou	karenn
zirappi	dirapi
feurzeski	peurzeski
pellweler	pellweler
Tenauenneu	tanavenn
adaolaskell	adaolaskell
chugudi	chugudi
loan	blein
kalzennou	kalzenn
penndoget	penndoget
turlebanein	turlebani
pourv	pourvez
predmern	predmerenn
Treuza	treuzitreuza
azibouez	azibouez
gweleado	gwelead
rog	rog
c'hrogbezin	krogbezhin
azkonta	askonta
listenn	listenn
zivrehonekat	divrezhonekaat
begeuhent	hent
agropajou	agropado
staldiegez	staldiegezh
alivegant	live
toulladet	toulladet
Paourdu	paourdu
andouviou	andouv
yekou	yeko
aoaenrud	rut
garakter	karakter
dreinella	treinellat
chimik	chimik
ta	'ta
diempennet	diempennet
c'hoania	koaniakoagnikoana
ormela	ourmela
dianvzerion	diavaezour
krabiseu	krabis
unaniez	unaniezh
skeudik	skeudik
eurbarti	parti
urgamdro	kammdro
ionfondizion	fonterfondour
para	para
mererez	mererezh
oberpinigenn	pinijenn
dic'hlorus	dic'hlorus
magadurus	magadurus
distrap	distrap
babourh	babourzh
laro	begad
averadou	averado
pechad	pezhiadpezhad
eurc'hlastenndero	glastennderv
Merabouji	bouji
baramouchen	mouchenn
dallpik	dallpik
breskadurez	breskadurezh
fuzulhienn	fuzuilhenn
abrantadeu	abrantado
kargaklenk	klenk
riad	euriad
gallegspagn	galleg
sec'het	sec'het
fruket	fruget
eurvez	eurvezh
digonsortiaj	digosortiaj
Pitenneg	pitenneg
emglevadeg	emglevadeg
Gouezelegva	gouezelegva
stardadenndourn	stardadenndorn
c'houskae	kouskaez
teferli	deferli
tarnredek	darnredek
tidebr	tidebr
bailladou	bailhad
Skrignegiz	Skrignegiz
strag	strak
Skarlatin	skarlatin
breizhveuriat	breizhveuriat
warvetek	warvetek
argesenn	kesenn
mezegloened	mezegloened
sabati	sabati
verzinan	milzina
dijoga	dijoga
kraouaree	are
boud	boud
lorhour	lorc'her
marholen	morzholenn
rodelvennek	elvennek
grabasek	krabasek
gurud	gurud
gazettennryen	kazetennerkazetennour
Basta	basta
bazadel	bazadell
gwiraer	gwiraer
souchenn	souchenn
dudius	dudius
diglaouier	diglaouier
aziabarz	aziabarzh
begbran	begbran
gallgar	gallgar
adranna	adranna
okiviz	kivizenn
breugeusus	breugeusus
izelvos	izelvos
mandoged	mandog
freilha	freilha
c'horreDoue	gorreDoue
hardel	kardell
redkorf	redkorf
urvorgleuenn	morgleuzenn
pifn	pifon
penndud	pennden
krabed	krab
brellet	brellet
didrugare	didrugarez
pikolen	pikolenn
adkustumi	adkustumi
Drfinklah	drefin
Pennsaouzanet	pennsaouzani
daroyall	darondell
dirounna	dironnadirounna
gaolirvinenn	kaolirvin
traezhet	traezhet
didennet	dedennadedenn
argouracherez	kouracherez
bikiliat	pikailhat
dichret	dicheret
lestrreder	lestrreder
ouidigouez	gouez
satandallet	satandallet
agroze	krozalkroza
Fidemdouen	fidamdouen
divesk	divesk
addibab	addibab
skabueu	skabev
c'houezaandraill	drailh
meilhonizat	meilhnizat
abradfe	prada
douaruz	douarus
digredenn	digredenn
yariganAotrouDoue	yarigDoueyariganAotrouDoue
diankinat	diankeniadiankenat
suiad	suiad
avein	aveiaven
lipad	lipad
Beuz	beuz
Antromor	tromor
polis	polis
bouloutenn	bouloutenn
diflip	diflip
kludet	kludet
Tepod	Tepod
enemanoazfe	anoazhi
azotek	azotek
Taga	taga
danvezkannad	danvezkannad
asted	asteud
c'hornaouek	kornaoueg
erion	gwenter
enemzrouransi	droukrasi
divanat	divanatdivani
Fuzilia	fuzuilha
choulaz	choulaz
zilibourein	dilibouri
koachkoukoug	koachkoukoug
strob	strob
Guitevediz	Gwitevediz
aoter	aoter
dizeveller	dezreveller
albaneg	albaneg
antadkozNedeleg	TadkozhNedeleg
adskrid	adskrid
d'oberegell	gell
mogeriaj	mogeriezhmogeriaj
effet	efed
tribunal	tribunal
chif	chif
divean	divaen
pennasket	pennaska
fias	fias
liantoh	liant
oberiantiz	oberiantiz
torcha	torchatorchi
Straojet	straoja
leunchek	leunchek
mitio	mitio
jakobinat	jakobinat
adhanvet	adenvel
Kefreder	kefreder
treboulaj	treboulaj
pourven	pourven
tamtamou	tamtam
parlantus	parlantus
dihuerhzein	diwerc'hezi
diskontereh	diskonterezh
divirit	diverit
undarinennablac'h	tarinenn
irlandiad	irlandiat
goenv	gwevn
uruisperen	gwesperenn
skoret	skora
aezennleski	aezhennleski
maivongez	maionez
daoulinet	daoulinet
digresqet	digreski
hanterdez	hanterdeiz
lammgalon	lammkalon
boustouf	boustouv
Deuuigent	daouugent
dirandoni	dirandoni
dervdero	derv
plen	plaen
diverramzer	diverramzer
bankpiltoz	bankpiltos
umzizunan	dizunani
klopin	klopin
Gonpagnoneh	kompagnunezh
loudourach	loudouraj
alammat	lammatlammetlammoutlammilampatlampout
uhelvrud	uhelvrud
rakpren	rakpren
koutikkoutig	koutik
golotaol	golotaol
rigolennein	riolenni
euskarat	euskarat
d'arc'havelbadisiant	kavellbadeziant
blasan	blaz
hevarc'hsteuer	marc'hsteuer
Eurgludenn	kludenn
arc'hloc'hglav	kloc'hgalv
bepenamzer	amzer
Bocuet	boku
Plouvornis	Plouvorniz
blansonet	plasonet
doubldro	doublderv
feid'andoujar	feizd'andojer
dic'hloar	dic'hloar
botzereh	botezerezh
pennglaouet	pennglaouet
diankedou	diankedo
nezigounnareket	digounnari
rizenn	rizenn
goion	goion
kadoriokofezion	kadorgofezion
zivretona	divretona
disvarn	disvarn
hollskedus	hollskedus
dilorc'h	dilorc'h
sachadegvleo	sachadegvlev
cherret	cheret
grizon	grizon
pout	pout
piastr	piastr
azaoulammas	daoulammatdaoulemel
fashafas	fashafas
divlaz	divlaz
diveuka	diveuka
torrreor	torrrevr
gouignal	gouignal
difin	difin
laouez	laouez
latinek	latinek
ptaulchanj	petaolchas
santualou	santual
waresourrou	sourro
kamdro	kammdro
sutellat	sutellasutellat
beogal	beogal
kaniet	kaniet
seblanteu	seblant
botas	potas
didorta	didorta
eurbellskridenn	pellskridenn
Ebanen	panenn
merak	merak
ostruj	strujenn
deurvenerel	dourvenerel
ainou	eno
bruget	bruget
diodez	diodez
skrilleta	skrilheta
lgardin	aelgardian
heskennerien	heskenner
bruderezh	bruderezh
chabo	chabo
gac'h	gac'hgarc'h
fakez	fakez
zraillerh	drailherezh
Drsour	dresour
rakleur	rakleur
dinamo	dinamo
d'oberpant	pant
arguchaden	kuzhiadenn
falzigerezh	falzigerezh
gallouaj	galouaj
brizmelen	brizhmelen
reigolo	rei
mestrgar	mestrgar
gwelienna	gweliena
abennhent	hent
Warbennarfin	warbennarfin
mouzourden	mouzourdenn
daskor	daskordakor
*colau	kelokelav
adro	adro
gwezstruj	gwezstruj
arveajourez	beajourez
darereh	daererezh
andanoen	tanavenn
saoennaou	saonenn
dic'haouiet	dic'haouiet
uhelwad	uhelwad
peurveget	peurvega
disoudart	disoudard
erc'hourenez	gourenez
Roumigell	roumigell
gwelead	gwelead
voulouzet	voulouzet
listenn	listenn
Beegad	begad
ramblus	ramblus
alintre	lintralintri
pasadeg	pasadeg
trejou	trejo
Ministrerezh	ministrerezh
daouvloazaden	daouvloazadenn
ressortchou	resort
vrhnoz	brizhnoz
pitaodes	pitaodez
gwaremmarglav	gwaremm
sklvah	sklavac'h
tourti	tourti
fulavienn	fulac'henn
c'hoaripenntourtik	tourtik
ancan	ankan
morgaouleg	morgaouleg
lestrkroazer	lestrkroazer
skrapereh	skraperezh
hersalhersein	hersalhersahersi
korfadur	korfadur
gerz	gerz
eurveltad	meltad
kenegon	kenek
oabren	oabrenn
arvarv	arvarv
gensakri	kensakri
litr	litr
Ahentad	hentad
diharak	diharak
sileu	sil
divreo	divrev
Adreizan	adreizha
furzod	fursot
pilligogwele	pilligwele
redadegou	redadeg
hantererez	hantererezh
alou	ali
sedsad	sed
ahardi	ahardizh
selletaer	sellataer
sachkrev	sachkreo
bornesed	bornez
Dilein	diwelei
forcher	forcher
soulgarg	soulgarg
zemplet	semplet
ahoudpegours	ac'houdepegoulz
tapetoselled	tapet
loraerion	loaraer
Bleunhanv	bleuvhav
dirapar	dirapar
eurvouden	moudenn
rozkaouled	rozkaouled
agign	agign
digourdi	digourdi
ranndi	ranndi
Pa	pa
aezoni	aezoni
sunet	sunet
bontet	bontet
skarp	skarp
dadkokenn	tadkokenn
Stoubennecq	stoubennek
Botsorc'hel	Bodsorc'hel
adrofall	adrofall
ekevred	ekevret
deveden	devedenn
rouletet	rouletat
morbiked	morbig
fuzillen	fuzuilhenn
gornok	kornk
zirabans	dirabas
ouket	oueka
gouez	gouez
Melenna	melenimelena
daveteg	davetek
amguzet	amguzhet
alamgaer	alammgaer
argarantevro	karantezvro
libouret	libouret
glazennek	glazennek
kedezkeded	kedez
zedert	sederaat
bobionaj	bobionaj
gurunaj	kurunaj
bidanig	bidan
io	plato
marvaillou	marvailh
eu	brae
doubleviou	doublevio
stamboet	stambod
brakognet	brakonibrakonia
laouenanigtort	laouenantort
aziwarlerc'h	aziwarlerc'h
konkonbr	kokombr
cuilhet	kuilhakuilhi
azibouez	azibouez
deizbloaz	deizbloaz
arwanten	gwantenn
fererezh	fererezh
riou	riv
balevarded	balevard
coufonchou	koufont
focher	fosier
jibosourh	jiboeserezh
toulldistro	toulldistro
laer	laer
hektar	hektar
plousaet	plousaet
loj	loch
displegadur	displegadur
afronje	fraojal
abuzet	abuziabuz
lrdislr	lavardislavar
tordidor	torrdidorr
magnous	magnous
dreujou	treuzo
brusk	brusk
ac'hrasDoue	ac'hrasDoue
bugelenn	bugelenn
kensakret	kensakret
Kaolirvin	kaolirvin
mlationeu	meulasion
entanet	entanet
geveria	keveria
azonenne	sonenni
puret	pura
Startaat	startaat
pederrodek	pederrodek
fulac'hen	fulac'henn
dourjostr	dourjostr
kaskalat	kaskalat
itik	itik
treban	treban
koachgoukoug	koachkoukoug
rebech	rebech
kotad	koataat
houarnerkezek	houarnerkezeg
adkempenn	adkempenn
flecheu	flech
ziaraokaat	diaraokaat
tenngrizou	grizou
ezansouer	ezasouer
fleriadenn	flaeriadenn
Kargachist	kargachistr
anerskalon	anerzhkalon
diskreunadur	digreunadur
voslagout	boslagout
aleizdourn	aleizhdorn
dissorb	disorb
dilzourz	dilezerez
ambulanso	ambulaso
bileradou	pilerad
fouailhet	fouailhet
androgorn	trogorntrogorn
enemizelaat	izelaat
ermeziad	ermaeziad
lergenn	lrgenn
dreeno	eno
comedianet	komedian
saprr	sapr'
vekanik	mekanik
sikourouz	sikoursikouri
loba	loba
aziflape	diflapa
plaouplaou	plaou
diboell	diboell
aliou	aliv
Kraouia	kraouia
divourapl	divourrapl
ivarh	ivarzh
Baragad	baragad
jugudi	chugudi
Flut	flut
mouchenn	mechenn
armedouar	armedouar
moucheted	moucheta
anamzerwechall	amzer
ardro	rdro
lammzailh	lammsailh
lestrchacher	lestrsacher
Vorgn	morgan
ripitaillez	ribitailhez
pentoniad	pentoniadpentonad
drezil	sil
manndraezh	mailhdraezh
gant	stonka
Termona	termona
leurfoar	leurfoar
diankachou	diankajo
Chipot	chipot
arboazadenn	poazhadenn
aispione	ispiona
digristenerez	digristinerezh
paska	paska
kanonek	kanonek
rifadennou	rifadenn
ergan	ergan
Walloned	Wallon
nozsac'h	nozsac'h
erhouiladentan	goueliadenn
chipotalvar	chipotalchipotat
mezevennet	mezevennet
kouloucherh	kouloucherezh
abaraz	para
niveradus	niveradus
orgeder	orgeder
aforhad	aforc'had
drahoantek	trac'hoantek
dogmatek	dogmatek
breizad	breizhat
askledennek	askloedennek
peziou	pezhc'hoari
manipul	manipul
maltoutereh	maltouterezh
lannek	lannek
anderzhienndifoeltr	terzhienndifoeltr
Argempennamant	kempennamant
dibistig	dibistig
boreieu	borei
adorimell	adorimell
klod	klod
goapereh	goapaerezh
beurziskuizha	peurziskuizha
lapousigarC'halvar	labousigarc'halvar
tabernakl	tabernakl
humvellein	mellamelli
begad	begad
ragoud	ragout
skandinavat	skandinavatskandinaviat
gijereh	gijerezh
kommandeost	koumananteost
paruigendad	pevarugentad
filimet	filimi
reimuzulbarr	muzul
eundarinen	tarinenn
Dirap	dirapi
domtt	dom
giniguerion	gwiniegour
avaloupechs	avalpechez
frinkerez	fringerez
Doublviou	doublevio
barillad	barilhad
ziodez	diodez
dipac'hao	dipac'hao
folizi	polez
leizadurez	leizhadurezh
Chinegr	chinegr
vaksinein	vaksinavaksini
ranner	ranner
razhedenn	razhedenn
Pimpanta	pimpanta
divinadell	divinadell
meineuroh	maenroc'h
pellskriverez	pellskriverezh
akes	akes
Europat	europat
lakaduntalad	talad
boumbesryen	bombezer
wardastoun	wardaston
dismato	dismantradismantridismantr
hanserion	hanezer
zedert	sederaat
reorwarwigour	revrwarwigour
prenestrkemener	prenestrkemener
lardonek	lardonek
zibluskenni	dibluskennadibluskenni
tihoulen	dihoulenni
Divenda	divent
avanazsouezet	souezhet
vilginek	milginek
pallennvoger	pallennmoger
dagnouzat	tagnouzaltagnouzattagnouzi
Likenn	likenn
adreuzvichanz	adreuzviziez
fleurpennkamm	fleurpennkamm
askampeubras	askampo
amguzhet	amguzhet
divouloutenn	divouloutenn
strakelkoat	strakellgoad
macheriou	macherio
beurgloza	peurgloza
diborhet	diborzhiadiborzha
trahoantekoh	trac'hoantek
gulkamp	gwelekamp
kraoueta	kraoeta
diskilh	diskilh
seblandicg	seblant
Chein	chein
Doc'hdoc'h	doc'h
pesketaour	pesketaer
tregorneu	trogorntrogorn
garmus	garmus
lostenndindan	lostenndindan
taolheurt	taolheurt
katakombou	katakombo
o	lord
ganten	kantenn
ziankadenno	diankadenn
daollabour	taollabour
Pikolenneu	pikolenn
lagout	lagout
didr	didaer
diktator	diktatour
nejet	neizhiet
enemripla	riblaribli
zrs	tres
byd	beiet
gwennig	gwennig
diakomod	diakomod
bauzt	babouzet
bautrarauk	paotraraok
Dibesket	dibesket
politik	politik
hentadeu	hentad
mamgouh	mammgozh
Periani	periani
dampret'vin	dampret
pempennou	pempenn
Ac'h	ac'h
genzakri	kensakri
fep	pepe
Paula	Paola
diskennbugale	diskennbugale
saoznek	saoznek
difaltazi	difaltazi
dilorhet	dilorc'ha
pennkenta	pennkenta
arBuritaniezh	puritaniezh
Belostou	belost
Divraza	divrazadivrazi
skladenneu	skladenn
baot	baot
hantergaon	hantergav
sapinen	sapinenn
damvoutin	damvoutin
Toc'hada	toc'hata
eillavaret	eillavarouteillavaret
Mopoch	poch
perkladur	perkladurperkadur
termer	termer
dilashoc'h	dilazh
dana	tana
Mn	Mon
gastelig	kastell
lahadegeu	lazhadeg
fontan	fontafonti
arebill	arebilh
pouellek	poellek
eatesutik	sutig
naerbuton	puton
korvigellet	korvigellet
Brant	berrentez
afuilh	afuilh
varnebeudadra	warnebeutadra
Previggoloig	prevgoulouig
dictatored	diktatour
difeiz	difeiz
doublediou	doublediou
barbot	barbot
aterseu	aters
avostadeu	avostado
darampontein	daramponti
spierien	spierspiour
vouisttermerz	termer
gourgana	gougana
zelluz	sellus
hersal	hersalhersahersi
aziarben	azirbenn
urvoujourden	mouzourdenn
c'honjesoudard	kojesoudard
dizanave	dizanavez
pato	pato
chaoket	chaoket
tumper	tumper
Noal	NoalPondivi
tintaleurger	tintaltinta
gourzerret	gouserret
klenk	klenk
loznedstlech	loenstlej
adselaou	adselaou
Koatet	koatet
lizertamall	lizhertamall
Grezennet	kleizhennet
boufamig	boufam
divroadeg	divroadeg
peurgontrol	peurgontrol
varc'hinkane	inkane
kuitaet	kuitaet
eoliet	eouliet
diambahet	diambazhet
podsukr	podsukr
iskounia	iskounia
dregichen	dregichen
presidet	prezida
Taolhatail	taolhatailh
Diloch	dilocha
Heodez	Heodez
koant	koant
predkoan	predkoan
bagour	bagour
chichantaat	sichantaat
kalsonen	kalsonenn
kopt	kopt
chakoniet	chakoniet
zisatanaza	disatanazi
eundroionenn	troionenn
Krazo	krazo
hantizeu	hantiz
ptrrous	paotrrous
dalc'hmatat	dalc'hmat
paad	pavad
didchadur	didechadur
rikamanet	rikamanet
beziad	beziad
boesoniet	boesoniaboesoni
bloaveziadennou	bloavezhiadenno
loustrom	loustrom
korven	korvenn
difeurm	difeurm
urupailh	urupailh
gavrvor	gavrvor
militu	millitu
shek	sec'hek
goulher	goulc'her
hilverket	hilverket
straniket	straniket
madetoh	madetoc'h
feald'	feal
hengounio	hengoun
adpaperad	adpaperaadpaperat
sklasa	sklasasklasi
streujaj	strouezhaj
Asegoz	gouez
Franseza	Fraseza
agatekize	katekizakatekizat
grisienna	grizienna
Feta	fe
Dreserez	dreserezh
tezennerien	tezenner
rgali	regali
frigaset	frigaset
c'harbden	garbedenn
abadenn	radio
areeflao	flav
dichanz	dichas
kazki	kazhki
eurgeriaden	kriadenn
reddired	reddired
peillertud	peilhertud
aliou	aliv
Jeun	jeun
dihanqein	dihanki
dinac'h	dinac'h
An	a
lanngalleg	lanngallek
disontil	disoutil
anunan	anunan
distagell	distagell
jeografi	jeografi
renkamanchou	renkamant
Serhus	serc'hus
dakor	daskordakor
digoumoul	digoumoul
adkempenn	adkempenn
mename	mename
ulliantoc'h	liant
broc'hadek	broc'hadeg
fonapl	fonnapl
laouenngoad	laoukoad
gleuennet	glaouennet
dornr	dorner
Tarlasker	tarlasker
patafourn	pataforn
divaoue	divaoue
pasket	paska
eurc'hasser	kaser
dakon	takon
diziaulein	diziaouli
blejadenn	blejadenn
fallout	fellelfelloutfallout
doubl	doubl
vrein	brein
distanus	distanus
albani	azbani
ankane	inkane
talori	talari
beredet	beredet
souhetoh	souezhet
marzenn	barzenn
zibohonein	diboc'honi
arwazennzour	gwazhennzourgwazhiennzourgwazhienndour
egamdro	kammdrei
penntiek	tiek
pennask	pennask
esklips	sklipsi
laerz	laerez
karzet	karzhet
dourtal	tourtaltourta
setuperak	setu
io	tapon
arc'hribellek	kribelleg
kefespern	kefespern
Lostigellat	lostigellat
liant	liant
keginata	keginata
spont	spont
c'hoarzadeg	c'hoarzhadeg
brec'hiou	brec'hkarr
skorf	skorf
'T'	't
burgondiad	burgondiat
Gouirikad	gwirikalgwirikat
peurgloza	peurgloza
arhvestroni	arc'hmestroni
surpilizet	sourpilizet
hengeltiek	hengeltiek
bragezpann	bragezpann
Lippouzen	lipouzenn
faroa	faro
lintra	lintralintri
dileton	dileton
lagout	lagout
lac'hadek	lazhadeg
c'hasti	gasti
difetet	difetet
breizad	breizhat
mintdu	mint
glaouch	glaouch
harpa	harpaharpi
vonbonaj	bobonaj
dichas	dichas
stallabouraddouar	stallabouratdouar
saveteryen	saveteer
skrifelleg	skrifelleg
uhel	uhel
kalmchok	kalmchok
andouzerez	touzerez
ervourbouterion	bourbouter
levrigtiegezh	levrigtiegezh
stronilluz	stronilhus
reiz	reizh
Chichantaet	sichantaat
varneztost	warnestost
klik	klik
bilhon	bilhon
izelaat	izelaat
chaogenta	chaogenta
digarnein	digarni
chojiged	choj
sutig	sutig
dieei	diweadiwei
pourvezas	pourvezas
digrogennet	digrogennet
beurblada	peurblada
trimar	trimard
fetekal	fetekal
tiJakou	tiJakou
varnhan	para
flatoullet	flatoullaflatoullat
pelurenn	pelurenn
bostlourelegou	boestrelego
dibouil	diboell
zegas	degasdegasi
divrezonekaet	divrezhonekaet
postkled	postkloued
eurgirinad	kirinad
dreboan	poan
raou	rav
gong	gong
dadra	dadra
kalfichadur	kalfichadur
urgouskerez	kouskerez
eeunhageeun	eeunhageeun
arroudennet	arroudennet
erbrofetz	profedezprofetez
chivous	chivous
Tennerpoltredou	tennerpoltredo
fourgad	fourgat
oafadeu	goafad
tonerdeal	tonerdeal
Nezifrommasket	difroma
abelldabell	abelldabell
diaoulbennet	diaoulbennet
devz	maez
tamall	tamall
arvarein	arvari
anell	anell
Brema	brema
skign	skign
skedus	skedus
zivagorias	divalgoriadivagoriat
bouloutenn	bouloutenn
fanisan	fanisa
arvoustetach	mousetaj
gwermin	dourgwermin
freget	freget
dourgan	dourgan
gwerigangweran	gwenegan
kilhard	kilhard
adlsur	adaolsur
Nonnd'ezi	nonn
TadarWirione	tadarwirionez
Damen	damen
zahtoaz	sac'htoaz
batorellet	batorellet
dkoai	dekoai
arganoliadeg	kanoliadeg
joup	joup
konision	konision
areuziado	areuziado
ran	ran
trompleur	trompler
aziwardro	aziwardro
roc'hiennet	roc'hiennet
azvuryou	azvur
engouez	gouez
menammein	manami
boutonkranpoeh	boutonkrampouezh
stennet	stennet
bouc'haboc'ha	bouc'ha
eurbrosesion	prosesion
pluet	pluvet
arc'holera	kolera
difeiz	difeiz
termaji	termaji
fulac'hen	fulac'henn
tribun	tribun
trinket	trinket
Aotervras	aoter
Saragi	saragi
ougnat	ognat
Marehamare	marehamare
stouet	stouet
tikanv	tikav
peurglozus	peurglozus
Kristenez	kristenezh
zegalennou	segalenn
lodenvar	lodennvarr
deuc'heugnal	teuc'heugnal
divrudet	divrudet
spinet	spinet
skignenn	skignenn
tieko	tieko
Paotein	paotri
kaz	kazhprad
eundommadenn	tommadenn
poenchen	poechenn
bisigedruz	bisig
ablean	plaen
Plok	plok
pln	plaen
yec'hedoniez	yec'hedoniezh
c'hoefbleo	koefblev
Libell	libell
hunkreizte	hunkreisteiz
pourv	pourvez
poellek	poellek
fourmajrouz	formajrous
aetepourren	pourren
deverrans	diverras
dilusenn	dilusenn
griadeg	kriadeg
Aginou	eno
addresa	addresa
Mardandouchenn	mardandouchenn
kraopichon	kraopichon
Lenn	lenn
pallenndaol	pallenndaol
stravaget	stravaget
breizad	breizhat
Beluga	belouga
dadpriol	tadpriol
flavdiflav	flavdiflav
gaskoign	gaskogn
douaroniel	douaroniel
diaozet	diaozet
brezelwenn	brezelgwenn
ravent	ravent
urbanen	panenn
divinim	divinim
jolimite	jolimitejolomite
gwelabl	gwelapl
bitellajou	bitellajo
annegoel	annevwelat
beurgloza	peurgloza
kankelankelan	kankelankelan
Yeued	yeu
digor	digor
skiltrek	skiltekskiltrek
nak	nak
eblomararza	arzav
Palatr	palatrez
parakurun	parakurun
gwareger	gwareger
republikan	republikan
romantourien	romanter
Difizias	difizias
alernet	gwalarni
stroallek	stroallek
kaouledet	kaouledet
boan	poan
kas	kas
diruilhadeg	diruilhadeg
ou	kop
donjeret	dojeret
guinpalms	gwinpalmez
c'hoarzingoap	goap
Babua	babua
goujard	goujard
advugale	advugel
medisinedloened	medisinloened
araffotflao	flav
buson	buson
sapaturus	sabaturus
etizalc'houe	dizalc'hweza
bastik	bastik
domajou	domaj
Budez	budez
komunitio	komuniti
agornzigoras	kornzigeri
bouednaered	bouednaered
enemzivrezonega	divrezhonega
ch	se
kreisteizkelc'h	kreisteizkelc'h
Gramadeger	gramadeger
mailh	mailh
souflez	souflez
liant	liant
breieu	brae
peurbrenet	peurbrena
agigseson	saesonsaezon
Kached	kached
ajorn	ajorn
didiva	didevidideva
skanveat	skavaat
briko	brikiobriko
lammpik	lammpik
flokon	flokon
chipotal	chipotalchipotat
motigbilhed	motigbilhed
boltret	poltred
sutadell	sutadell
buezekt	buhezekaat
skoanenn	skoanennlaezh
diodet	diodet
stoupik	stoupig
gobrginaj	ginaj
Amgav	amgav
dibouloud	dibouloud
c'hoarikoachkoukoug	koachkoukoug
Erharigkanour	karvigkaner
skosellek	skosellek
produerion	produer
kuzulren	kuzulren
berluronaj	berluronaj
Lavarenngouzisplega	gouzisplega
bleunkurun	bleuvkuruno
dizouea	dizouea
egizall	egizall
dizoaret	dizouaret
piladdour	piladdour
wardrenv	wardrev
wardre	wardrev
lardeza	lardeza
daoubenni	daoubenni
startad	startaat
anterbreudeur	hantervreur
ac'henaouadou	ac'henaouado
diskramailherez	diskramailherezh
krennhakrenn	krennhakrenn
atil	atil
fava	favaj
truilhennek	truilhennek
gotek	gotek
speguz	spegus
gaouet	gaouet
telefon	telefon
petailh	petailh
parlammein	pevarlammatpevarlammi
vaonnettez	baionetez
karregtarz	karregtarzh
paoad	pavad
Abadez	abadez
melc'houedklorek	klorek
liserenn	liselenn
Bill	bilh
liorzhporzh	liorzhporzh
Chintra	chintra
diret	diret
vureaubutun	burevbutun
fennaska	pennaska
dorten	tortenn
latinerez	latinerezh
mardoundechoun	mardondechon
pimpilh	pempilh
plijapl	plijapl
adree	adreze
disc'hreui	disc'hreuni
tistoko	distokadistoki
fransezad	frasezat
spered	debret
tossenneg	tosennek
Tobias	Tobiaz
Bremaik	bremaik
treuzeuler	treuzeurel
logenn	logenn
froudad	froudad
azveva	azbevaazbevi
koko	koko
digornek	digornek
arglochenn	klochenn
enemgatailhat	katailhat
yalc'her	yalc'heryalc'hour
fregann	fregant
Makedoniad	Makedoniad
eunan	eunan
Kaergeno	kaergeno
Disvalat	disvaladisvalat
bali	bali
diseulet	disoulet
dihus	diuz
adaol	adaol
venjansus	vejasusvejasius
zisvoueda	disvouedadisvouedi
saotr	saotr
hurt	heurt
digozet	digozhet
pastellvot	pastellvot(i)
farzpenn	farzpenn
dedenna	dedennadedenn
lammkalon	lammkalon
chukat	chukat
kanonek	kanonek
neijerz	nijerez
mezdafonta	fontafonti
grasta	krasta
kabochat	kabochat
elampazganti	lammatlammetlammoutlammilampatlampout
ouarnerkezek	houarnerkezeg
dihaill	dic'hailh
didagein	didaga
c'halvagnat	galvagnatgalvagna
gwaskedennet	gwaskedennet
Beuchbeuch	beuch
beurlenn	peurlenn
Soniri	soniri
fliouie	fliouial
adltarz	adaoltarzh
skoazeller	skoazeller
bleuribot	bleuvribod
stonn	stonn
Gallegsaout	galleg
mojiloriken	mojilorikenn
gwerenngriski	gwerenngreski
zavanac'h	saevanac'h
arbromesa	promesa
tiezpedi	tipedi
urgrampouezhennbardon	krampouezhenn
enebkurun	enepkurun
fater	pater
Petraafelld'eoc'h	fellelfelloutfallout
harzdiharz	diharz
pln	plaen
prehsion	predesionprehesion
en	dervenn
Tatakoz	tatakozhtatagozh
emzioal	emziwall
diseulereh	disoulerezh
mesou	maez
warhednebeud	warhednebeut
etraou	etrao
kilkrog	kilkrog
farwell	farouell
d'entardetan	tardet
stlepdour	stlepdour
gwenva	gwenva
kinglav	kinglav
gratouilh	gratouilh
adstardan	adstarda
t	tufa
kornbleg	kornpleg
c'houekder	c'hwekter
glouistr	gloestr
Skarbellat	skarbellat
volkan	volkan
andarzvenveure	tarzhennveure
chentilt	jentilaat
anwazet	anoazhet
meskdivesk	mesk
tins	dis
nijerezed	nijerez
askaout	askavout
kailhebok	kailhebog
diodet	diodet
istrimant	istrimant
veilhena	gweliena
gwanijenn	gwanijenn
dironkennat	dironkennat
frofiden	profidenn
frouezierez	frouezherezfrouezhierez
dopinat	toupina
adreuzwel	adreuzwel
ali	ali
Basting	bastik
laviga	lavigalavigat
difich	difich
Mardousten	mardousten
begasenn	begasenn
kargloud	kargloud
diribinenn	diribinenn
aberc'hennas	perc'hennaperc'henni
arboan	poan
spoesa	spoesa
sahtor	sac'htor
lustrugen	lustrugenn
digemmeska	digemmeska
klaskeribinou	ribin
etretreid	etretreid
galjor	galjor
agentc'houzanve	kentc'houzav
bourdedus	bourdedus
Krankchevr	krankchevr
'nhent	penent
Randounenna	randonennarandonennat
damvoal	damvoal
Ouc'hou	ouc'hou
groenlandeg	greunlandeg
razeden	razhedenn
trilamm	trilamm
klnk	klenk
meancorn	maenkorn
goular	goular
eurwiziad	gwiziadgwizad
visioni	misionimisionat
tourral	doural
malloztouen	mallozhtouenn
waregrabousou	kraboso
nneu	brochenn
kalite	kalite
epareche	parea
eurc'houdorenn	goudorenn
stri	str
stervennyen	stervenneg
Jakod	chakot
Ampusturi	ampusturi
enemdourtal	tourtaltourta
Etrekeltiek	ektrekeltiek
Bidanellat	bidanellat
eurc'hlaoerez	glaverez
amzeriet	amzeriet
urgamdro	kammdro
talbaget	talbaget
gallegsaout	galleg
safarus	safarusaat
tisrevi	disrevi
VroDreger	BroDreger
janglenn	janglenn
barabonimal	bonimal
daoulinet	daoulinet
askuizasganeomp	skuizha
treuzeuler	treuzeurel
skoazbleg	skoazpleg
korilh	korilh
bourbonenn	bourbonenn
chistrereh	sistraerezh
sac'hdrag	sac'hdrag
cheikh	cheik
a'freilhate	freilhata
zifoura	difoura
furiked	furig
skrapadeg	skrapadeg
awev	awev
gav	kav
beurziskouez	peurziskouez
abazeukah	abazokazh
boufoned	boufoniboufonal
doarlabour	douarlabour
lintra	lintralintri
argioc'h	gioc'hkioc'h
komtach	kontaj
Aksiantet	aksiantet
boulouardad	boulouardad
doanik	doanik
bitatiz	bitatis
fic'hellat	fic'hellat
pouillajal	pouilhajal
poupigou	poupig
horossat	horosi
azigouezaz	digouezha
plonjadenn	plojadenn
amboubal	amboubal
boteierflakez	flakez
redererevr	redererevr
dibrenn	dibrenn
broendu	broendu
rounter	ronter
plaou	plaou
Folklorek	folklorek
magedoull	magedoull
renket	renket
ratozhet	ratozhet
we	gouez
askoras	skora
anNivod	Nivod
fard	fard
Armamant	armamant
meanpouez	maenpouez
lomanaocher	aocher
Ragoplaen	ragout
Fachanitrikou	Fach
tortellou	tortell
konkouri	konkouri
tachet	tachet
amboubal	amboubal
oberd'ezi	diaez
dizomach	dizomaj
attrision	atrision
aboagn	poagn
flep	flap
tout	touet
astommet	astommet
presleoriou	preslevrio
krakhakrak	krakhakrak
lovra	loralori
anemized	anemiz
n'enemdopinket	toupina
bokejounaer	bokednaer
eullounkezizun	lonkesizhun
diyalc'ha	diyalc'ha
area	glav
peurziluzia	peurziluzia
krenioh	krenioh
sac'hrouz	sac'hrous
diesperans	diesperas
divouedet	divouedet
divec'hia	divec'hiadivec'hadivec'hi
moustougnet	moustougnet
marrer	marrer
krachen	krachenn
striour	strevier
vrezelarGroaz	kroaz
andouribel	touribell
digasamzer	degasamzer
disparidigez	disparidigezh
adeureuji	adeuredi
Kredioun	'kre
enebsoudardrez	enepsoudarderezh
sin	sin
romanter	romanter
dredan	karrdredan
pourset	pourset
roustadbazadou	roustad
dousik	dousik
bagvalumeta	bagvalumeta
distradet	distradet
Fanch	Fach
farloket	farloket
latinat	latinat
barbot	barbot
roustadenn	roustadenn
beghent	hent
disivouder	disivouder
divach	divacha
zederded	sederded
Adouilhan	adouilha
skanvadurez	skavadurezh
freac'h	freac'h
amenuziri	amunuziri
pusuniour	pusunier
Bittarabez	beterabez
ebata	dibata
dreistsonek	dreistsonek
disoudard	disoudard
chubaj	skubaj
touelluz	touellus
digav	digav
DirdignDirdignDirdign	dirdign
loc'het	loc'het
dilabour	dilabour
aruzreor	aruzrevr
tanflammet	tanflammet
chenechaliah	senesaliezh
Staoniata	staoniata
breanek	breanek
digemerans	degemeras
diyunet	diyunet
disudardein	disoudardadisoudardi
ajant	adjantmaer
barbilitaj	barbilitaj
diduemmein	didomma
zaldibri	saldebri
kroza	krozalkroza
gouzal	gouzer
daouhant	daouc'hant
semeill	semeilh
argreuzeulnoz	kleuzeurnoz
c'hoarihadisc'hoari	disc'hoari
arvoc'h	boc'h
efeur	efeur
tiseah	disaezhi
advota	advota
lztourgouilhet	laezhtourgouilhet
merhererbijon	bijon
barnerenklask	barnerenklask
ali	ali
nijen	nizien
begad	begad
bourennat	pourennat
dineza	dinezadinezi
dirod	dirod
kabelleupilr	kabellpiler
disorb	disorb
nerzet	nerzhet
bailhoba	bailhoba
taeret	taeret
divleupet	divleupa
rozetennet	rozetennet
abaradeu	abareado
Eurbevaren	pevarenn
gamachenn	gamachenn
skontaillek	spontailhek
daich	deich
bilhbilh	bilh
sin	sin
poellus	poellus
difoupet	difoupet
mouskreien	mouskreien
skoret	skoret
difall	difall
prodision	predesionprehesion
qerlet	kerli
souchenn	souchenn
simoniezh	simoniezh
sederaat	sederaat
garhein	garzhi
danv	dov
urgouskadenn	kouskadenn
gweturier	gweturier
mester	mester
zea	zealzea
c'halvagna	galvagnatgalvagna
meingaioc'h	maengaioc'h
mardoust	mardoust
meinrodell	rodell
krapos	krapoz
buzelladeg	buselladeg
boc'h	boc'h
London	London
Mitenneg	mitennek
hunkreiste	hunkreisteiz
siliet	siliet
aglaskasoribinou	ribin
rodvlenia	rodvleina
goudorez	goudorez
likoz	likoez
krogennet	krogennet
dirason	dirason
boutaouerkoad	botaouerkoad
wardrenv	wardrev
Plourac'hiz	Plourac'hiz
ajina	ajina
elakouasbanni	azbani
ouagouillat	gouagouilhat
zuilhet	suilhasuilhi
enbrall	brall
Flagennet	flagennet
ramplus	ramplus
bidiezi	bidiez
Erveajerz	beajourez
logoterz	logoterez
dielc'het	dielc'hetdihelc'het
fondet	fontafonti
kalapiazo	kalapi
flut	flut
abepgiz	abepgiz
trougcalon	drougkalon
Normandi	Normandi
Luchkatre	katre
koefoupln	koefplaen
dizudi	dizudi
brein	brein
dibrepar	dibrepar
bolanjeriboulanjeri	bolojeri
didhus	didec'hus
all	all
disal	disaldisi
zourjostr	dourjostr
postereh	posterezh
C'holala	c'holala
Eurgoantenn	koantenn
pitaud	pitaod
fionnereh	fionerezh
anveadek	anneuadeg
azourc'houez	sourc'hwezha
diskeud	diskeud
vez	penndevezh
troennou	troienn
digabestenni	digabestrenni
Torcheu	torcho
forantez	forantez
da	dov
evotzadr	botezadi
plesennet	plezhennet
anndentasion	temptasion
azifrinke	difrinka
silet	silet
zammad	sammad
felled'	fellelfelloutfallout
gouez	gouez
poupik	poupig
Grekenn	grekenn
MabichigouMareo	mabisigomarev
riblenn	riblenn
taolred	taolred
kakac'hig	kakac'hig
gorzet	goursezal
zimplhazimpl	semplhasempl
kordennad	kordennad
argaden	argadenn
mlen	melenn
andon	andon
selaouerien	selaouer
redadec	redadeg
eurhej	kej
marventeziou	marventez
Eundirienen	tirienenn
berridet	berridet
Dilosta	dilostadilosti
adtammet	adtamma
toutek	toutek
protestant	protestant
dquel	kel
Rugagn	rugagn
fidorius	fidorius
cheik	cheik
guelderhuel	gwelldrewell
istre'vithi	estrevit
naroudnarabez	roud
Gallegpodou	galleg
hengembraek	hengembraek
varneztost	warnestost
dieko	tieko
flouret	flouret
diglotenn	diglotenn
boestvutun	boestvutun
dorgoilha	tourgouilha
zonteal	sonteal
motet	motet
krasset	kraset
riblenn	riblenn
staldiegezh	staldiegezh
taper	taper
ruzell	ruzellveure
eurc'hataflam	kataflam
arneuen	arnevenn
mor	digor
lounkezizun	lonkesizhun
direligion	direlijion
abeurdorr	peurderri
distokad	distokad
ormela	ourmela
dadaneal	tanealtaneval
GoueledKerne	GoueledKernev
louzerez	louzerezh
marnao	marnaou
damvaro	damvarv
biou	biou
Pivit	pibid
dantlet	dantellet
Rask	raskl
peuzkerkent	peuzkerkent
torchennet	torchennet
pommelek	pommelek
inutul	inutil
enememelledeuz	emelloutemella
chif	chif
Begfigus	begfigus
brasibrasou	brasibrasou
ekonomikel	ekonomikel
aoultrrs	avoultrerezavoultrierez
jalgod	jalgod
fariaden	faziadenn
azianbarh	aziabarzh
tammhatamm	tammhatamm
goaf	goaf
skrignour	skrigner
erhavour	kaver
diouz	goudor
galouach	galouaj
vonal	vonal
zouarenn	douarenn
manganez	manganez
dizakr	disakr
adkemeret	adkemer
karred	karred
Henthouarn	henthouarn
poanbleo	poanvlev
Loegaj	loegaj
didu	didu
Peurreiz	peurreizh
strogach	strogaj
houilmikl	Mikael
eu	oes
sammus	sammus
polis	polis
skriddanevell	skriddanevell
soniadurez	soniadurezh
ligarbaradoz	aeligarbaradoz
koata	koata
spizryen	spiser
delc'hanz	dalc'has
erminiget	erminiget
repuet	repuet
pansiona	pasiona
Vampriol	priol
brada	prada
Dismant	dismantradismantridismantr
doanig	doanik
saden	aesadenn
c'hwibumouifubumoui	c'hwibumoui
ensiellas	siellasielli
dakor	daskordakor
nuen	navenn
diskempennerez	diskempennerezh
salad	salead
unyeza	unyezha
Bill	bilh
kasta	kasta
klanvaet	klavaet
dispeuh	dispeoc'h
parezon	parezon
dibellet	dibellet
saltaul	seul
legestra	legestra
arhlik	klik
ed	megel
Damnac'hdavin	damnac'hdavin
Urvuruzenn	buruzenn
Perwenaniz	Perwenaniz
blaz	blaz
baramoul	baramoull
pistiga	pistiga
gwina	gwinagwinat
Labourerezdouar	labourerezhdouar
diglink	diglink
divourdein	divourdi
urc'hlevezenn	glevezenn
eunan	eunan
holenerien	holener
eurgompagnunez	kompagnunezh
dinec'h	dinec'h
alamgaer	alammgaer
gasteit	gastaat
bourusat	bourrusaat
n'hoflippannmeket	flipaflipatflipi
behinned	bezhinevned
planchodet	plachodet
Jakez	Jakez
pizen	pizhenn
Kantrener	kantrener
sonereh	sonerezh
ofiseravor	ofiseravor
gilhezenn	kilhezenn
GoueledKerne	KernevKerne
kenetrezoc'h	kenetre
devatein	divatadivati
anou	eno
Gwalhinachou	gwalc'hinajo
Diakachou	diankajo
dichekadenn	dichekadenn
skorer	skorer
skrignet	skrignet
diouela	diouela
tosttos	tostos
slavoneg	slavoneg
hentboent	neinboent
deveziad	devezhiad
pevareamazer	Pevareamzer
lezireg	lezireg
pavgwan	pavgwan
liestroadek	liestroadek
bouroueller	bouroueller
peurgloza	peurgloza
urc'hender	kenderv
diginkl	diginkl
chouchet	souchet
arc'hermanegouriezh	germanegouriezh
hamdroieu	kammdro
digedaoudaoudigedaoudaou	digedaoudaou
banktl	banktaol
rous	soubilh
Takebien	takebien
dichret	dicheret
rozel	rozellgrampouezh
mourenna	mourrenna
avad	avat
flatoull	flatoull
ogignen	ogignen
trist	trist
finaat	finaat
tosteno	eno
laqueittm	meizmez
paperleve	paperleve
flammflimmin	flimin
boskardet	boskardet
ehloann	gloanigwlani
oskarolez	skarolezenn
Pennmailh	mailh
skuiza	skuizha
avnfianskaer	avenefias
c'haradeun	karadeun
pluennoerc'h	pluerc'h
leurenn	leurenn
tarodigantarsec'hed	tarodi
Ragalaj	ragalaj
waryun	waryun
ergordengroug	kordenngroug
eno	eno
doanateuz	doan
sonjal	sojalsoji
yuzeveg	yuzeveg
arc'hafeta	kafeta
digoummoulla	digoumouladigoumouli
Korbiner	korbiner
fd'amdoustek	fedamdoustek
alkool	alkool
heoliet	heoliet
erFretu	Fretu
dizanket	disanket
sigur	esigur
flemmet	flemmet
Koz	kozh
krankglas	krankglas
disparl	disparl
lestrkroazer	kroazer
Lenn	lenn
bremanik	bremanik
Bnavad	bon
zihanio	dihinia
Kenglot	kenglot
asprena	asprena
mangrellet	magrellet
mavoalskoit	gwallskei
eviddoare	evitdoare
kelaneu	kelan
tartouz	tartouz
peurderri	peurderri
digasas	degasdegasi
farsellat	farsellat
marbijedoan	doan
arvalerezkafe	malerezkafe
rangaut	reungeot
Vargoulen	goulenn
hirsonjal	hirsojal
peurlaza	peurlazha
planiet	plaia
andounandiaoul	andon
Fidam	fidam
setuma	setu
skiantel	skiantel
feka	feka
dizro	dizro
dreeno	eno
konstripet	kostripa
galianek	galianek
diskoazel	diskoazell
avirville	birvilhabirvilhat
ervlen	melenn
m'	er
difich	difich
oksijen	oksijen
enememellout	emelloutemella
Buladiz	Buladiz
stlabezus	stlabezussklabezus
dizabet	dizabet
EroanTalberz	Talberzh
lardouzennet	lardouzennet
Chicardi	chigardachigardi
sekin	zoken
merc'herio	Merc'her
koulbad	koublad
Tregeriad	tregeriat
Kanuel	Kanuhel
unyeza	unyezha
dihaosterez	dihosterezh
skanvadurez	skavadurezh
kaerderiou	kaerder
zelltro	selltro
patromet	patromet
fourradou	fourrad
Kilbenni	kilbenni
azivec'hias	divec'hiadivec'hadivec'hi
trucha	trucha
vionderh	vionderezh
Treispennet	treispennet
houbet	houbet
ostatet	ostant
leztud	leztud
Dampredevo	dampret
dic'hraus	dic'hraus
ranezenni	ranezenni
mnpouez	maenpouez
zistribilhenna	distribilhenna
maluret	maluret
dic'harzh	dic'harzh
c'houiledraden	c'hwilraden
Noluen	Nolwenn
hollgaerder	hollgaerder
boulzero	boulzerv
ramblereh	ramblerezh
aluzennet	aluzeni
agreiz	agreiz
kazet	kazoutkazet
foullmac'het	foulmac'het
troc'herbuzug	troc'herbuzhug
personarc'hbeleg	personarc'hbeleg
imurein	imori
keliengorilh	gorilh
fidamdoulle	fidamdoulle
agafourch	agafourch
hlazeri	glazeri
digarteria	digarteria
kiviz	kiviz
kadorzougen	kadordougen
libousten	liboustenn
peurliesa	peurliesa
terka	teka
everans	everias
gwenodenn	nodenn
Agreis	agreiz
lonkesizun	lonkesizhun
leurenn	leurenn
papurus	papuruz
abeurlar	peurlaerezh
strapa	strapastrapat
kroazigell	kroazigell
Benkoltoz	bezhinkoltoz
budet	budet
cartouchen	kartouchenn
fourrad	fourrad
liod	liod
mac'hagn	mac'hagn
c'hourizspoue	gourizspoue
lostad	lostad
ankoua	ankoua
Ahoudez	ac'houdese
karzant	karzant
brezonega	brezhonega
Ac'hac'h	ac'h
rigolen	riolenn
alammoupenn	alammopenn
pezia	pezhia
emdouell	emdouell
eusandiwarlerc'h	diwarlerc'h
Heido	heido
ealmirer	aelmirer
herminiget	erminiget
atahinereh	atahinerezh
bud	bud(ik)
ploupa	ploupa
abareas	parea
galjor	galjor
goudor	goudor
jeun	jeun
maniok	maniok
choupa	choupa
diambrnnek	diambrenek
tremenus	tremenus
kanolierez	kanolierezhkanonerezh
astalgostez	astalgostez
hoariel	c'hoariell
chalennourchadennour	chadenner
encrezi	enkrezi
grilhedglas	grilhglas
kigmir	kigmir
dampretevijetoud	dampret
flatrat	flaterat
enavent	Azvent
fourbichour	fourboucher
kubet	kubet
bo	bo
argouignennamann	kouignennamann
tezenna	tezenna
arokaat	araokaat
ion	diskonter
ravent	ravent
toupenneg	toupennek
koadlabour	koadlabour
bolc'het	boulc'het
chugudet	chugudet
barfetegez	parfetegezh
Chistrouenn	chistrouenn
lorvez	lorwez
tolhiatat	toc'hata
lisereh	lesaerezh
scocellec	skosellek
listrikegin	lestrkegin
dus	dus
dizuah	dizoazh
drebiou	drebiou
Jarlez	Charlez
afasdezha	afas
hadvue	advuhez
minottou	menot
etarzigellas	tarzhigelli
c'huybanadennou	c'hwibanadenn
jip	jip
Blank	blank
sujedi	sujedi
zidreunia	didroc'holia
andailh	tailh
adrovrec'h	adrovrec'h
bourjin	bourjin
enebas	enebas
lugumacherien	legumajer
direnna	dironnadirounna
hernachou	hernaj
rabotet	rabotet
trhiadur	drec'hadur
minoerou	minouer
rouletat	rouletat
badaouinet	badaouina
ahurlamm	gourlamm
ahanterzodas	hantersodi
dirasa	dirasadirasidiras
lousoniet	lousonia
Distoladennou	distaoladenn
finvadennou	fivadenn
bernieukroz	bernkroaz
maneur	maneur
digor	digor
divist	divistr
vouta	bouta
tamgloza	damgloza
dregorn	trogorntrogorn
c'horven	korvenn
rinkunus	rukunus
Kosennriz	kosenn
vloubloufal	bloubloufal
kriadek	kriadeg
ursaladarlerh	salead
erhoaddero	derv
yen	yen
goeladek	goueladeg
dizesk	dizesk
c'hordenvec'h	kordennvec'h
vali	bali
parchanti	parchanti
piastr	piastr
divilgin	divilgin
maniok	maniok
mallezhtoueo	mallozhtoueo
armeria	armeria
diwarlerc'hiet	diwarlerc'hiet
bannkroz	kroaz
aes	aez
verenvihan	merennvihan
dizoac'ha	dizoac'ha
diehan	diehan
peuzhenvel	peuzhevel
raca	raka
ilizez	irinjez
nanoazoketouthe	noazoutnoazinoaz
oanbourd	bourd
buzugenna	buzhugennabuzhugennatbuzhugenni
differ	difer
C'hoantasik	c'hoantastikc'hoantasik
kuli	kulakuli
Chorennet	chorennet
entenn	eeuntenn
ekreizetre	ekreizetreekreiztre
Agomans	agomas
baraen	baraenn
radenadek	radenadeg
abephent	hent
hek	hek
diszi	diseziz
C'hwibez	c'hwibez
skarlatin	skarlatin
eurbilliglostennek	lostennek
vrizaotroned	brizhaotrou
difidled	difidel
c'hlemmuskerez	klemmuskerezh
hadveo	advev
deizhadeiz	deizhadeiz
eeunhageeun	eeunhageeun
strobdistrob	strobdistrob
strollenna	strollenna
krampouezlogod	krampouezhlogod
hokouelmiklez	gouelMikaelez
zidalla	dizalla
skedus	skedus
pennkentan	pennkenta
peurlaeret	peurlaerezh
bodad	bodad
peuzhenvel	peuzhevel
koricher	kouricher
krannek	krannek
folitikaj	politikaj
marvlivet	marvlivet
eunan	eunan
alampik	alammpik
Saig	Saig
dibistik	dibistig
karot	karot
ahelpennkaer	ahelpennkaer
tabore	tabore
peurzeski	peurzeski
dimeus	dimeus
hepgoulennnadiskenn	goulenn
custodo	kustod
Loeizig	Loeiz
flanerez	flanerezh
tammdredamm	tammdredamm
deverranseu	diverras
pehbreing	brein
goaspell	gwaspell
Nevenoe	Neveno
fennegezh	pennegezh
salmr	salmer
krahig	krac'hig
pikotad	pikotapikotat
danhouaden	tavadenn
avilbell	avilbell
nasket	nasket
poldoket	poldoka
Disabr	disabr
heido	heido
komprenasion	komprenasion
ston	stonn
hantera	hanterahanteri
mann	mann
adakadou	adakado
ovondwargreva	kreva
doullbac'ha	toullbac'ha
kouskourez	kouskerez
zirikla	dirikla
neuc'h	neuc'h
eurc'hiosk	kiosk
diavzein	diavaezi
gorven	gorvenngorbenn
alvaonet	alvaonet
Fdam	fedam
satanazet	satanazet
satordistac'h	satordistac'h
fichetad	fichedad
torrlizer	torrlizher
morEnezek	enezek
Drfinklah	drefin
eundommaden	tommadenn
disliamma	disliamma
Stopein	stopastopi
digrec'h	digrec'h
limaj	limaj
collet	koll
stol	stol
flakotat	flakotat
dorvolz	dorvolz
lammetareasgant	lammatlammetlammoutlammilampatlampout
karvet	karvet
eneurgrouman	krouma
kammdrgamm	kammdregamm
Pelzoig	pellzoik
chourikereh	chourikerezh
toulandar	toullandar
goutur	kouter
estrevijiri	estrebedestreved
Rasklenn	rasklenn
regali	regali
eurc'hlarenn	glarenn
digarg	digarg
rivet	rivet
eilsonet	eilseni
divlaz	divlaz
zabati	sabati
argantvloaziadez	kantvloaziadez
fondein	fontafonti
digomz	digomz
asbueza	azbuheza
divadaouet	divadaouet
chuchu	chuchu
c'hwistim	c'hwistim
machagrifo	macha
meat	meatmeal
tafaner	tafaner
pallennleur	pallennleur
urvourdachenn	bordajenn
souchen	souchenn
eien	brell
diouiziekwar	diouiziek
lip	lip
Rinik	rinik
ruion	ruzion
gloeveg	gloeveg
addihuni	addihuni
flamm	nevezflamm
ruzard	ruzart
guinver	gwiver
Romantism	romantism
dizeureuji	dizeuredi
advoulladur	advoulladur
brosezi	proseziprosezal
droadmaout	troadmaout
maouttourz	tourz
potredarc'hilkrog	kilkrog
iverzoniad	iwerzhonat
binyou	beni
stapen	stapenn
Sklaogennat	sklaogennat
sebouten	sebouti
tihour	tihour
baitel	bavitell
moraj	moraj
tennaj	tennaj
moneddelala	lalla
eulfen	elfenndan
skedus	skedus
Geuniaouek	geuniaouek
glazvezet	glasvezet
Andrikenn	trikenn
dic'heot	dic'heot
mlasion	meulasion
Droleit	drolaat
Doureget	dourega
sabadac'het	sabadac'het
amannrouzet	rouzet
glanatereh	klezeataerezh
bon	beon
porzhiopesketaerezh	porzhpesketaerezh
arazaill	razailh
forluok	forluok
bertimein	bertimi
glotennet	klotennet
larerion	lavarer
ed	droch
DragDrag	drag
eurglakien	klakienn
koatet	koatet
ekuit	ekuit
dibistik	dibistig
lezober	lezober
freskus	freskus
sonjalarneh	sojalsoji
Penkosare	pennkozh
hesqennour	heskenner
lechefread	lichefread
zoratat	doareata
mezellerez	mezellerez
diskloummet	diskoulmadiskoulm
debebkours	koulz
vouched	mouched
muzunou	munsun
deurbi	dourbev
las	las
atahinour	atahiner
StajoUnanet	StadoUnanet
kammober	kammober
ennog	sklaogenneg
plapoteu	plapot
dizec'het	disec'het
seizien	seizien
Diouiziek	diouiziek
Abenndimeurzpennzizun	pennsizhun
gouteldag	kontelldag
vikinik	mekanik
maneur	maneur
divicher	divicher
tiryen	pradtirien
divelek	diveleg
ou	borod
hadnerzet	adnerzhet
mellad	mellad
argaden	argadenn
biekat	bevekaat
bkerehbekereh	bekerezh
Hoc'hhoc'hhoc'h	hoc'h
vodka	vodka
adnevezi	adnevezi
Drezecq	drezeg
zabati	sabati
digor	digor
Alpek	alpek
falgonz	fallgomz
bostu	bostu
rouanez	rouanez
argannereznoz	kannereznoz
chigard	chigardachigardi
peurdifoeltret	peurzifoeltra
rakvarnio	rakvarn
reorwarwigour	gwigour
spegus	spegus
cheleuetan	selaouet
pozet	pozet
dousn	dousenn
Eurc'houlbad	koublad
jeromig	jeromig
grammenni	kramenni
argrumpez	krumpez
skumennek	skumennek
piladeg	piladeg
kalvezmein	kalvezmein
nerzkaloun	nerzhkalon
hoper	hopernoz
tregor	tregor
gwinsutik	sutik
fellryen	feller
dibesket	dibesket
c'hoarierez	c'hoarierezh
adstudia	adstudia
breizad	breizhat
sammusoc'h	sammus
balibordaj	balibordaj
achant	achant
aziarvz	azirvaez
digouezet	degouezhet
latinek	latinek
ragaoza	ragaoza
ranngalon	ranngalon
Paotrenivineuhir	paotranivinohir
touzyerou	aoter
gadorpedi	kadorbedi
kantenn	kantenn
divaoue	divaoue
barrazennou	barrasenn
erhloehen	glizhenngwlizhenn
panerer	panerer
zaneval	tanealtaneval
arc'holebriz	kolebrizh
boleet	boleaboleatbolei
diderm	diderm
louaichryen	louajer
pildour	pildour
Lostigenni	lostigenni
kiminell	kiminell
andanadures	tanadurezh
dihopr	dic'hopr
grim	grim
skrebeliet	skrebeilhet
treuza	treuzitreuza
Diardeuet	diardeuet
telegraf	telegraf
abalafin	abalafin
adrzhagadal	adreuzhagadal
peurzeski	peurzeski
grosmortez	grosmortez
urvorbouten	bourboutenn
lostenni	lostennilostenna
mogeriach	mogeriezhmogeriaj
morgeuled	morgaoulenn
bon	bon
ervorc'haden	bourc'hadenn
nerzkalon	nerzhkalon
panerkarrez	panergarrez
Flegenn	flegenn
paouranteachou	paourentezajo
mann	mann
arc'holler	koller
choukad	choukad
Ahentad	ahentadahentado
begmazk	begmazog
bouselleion	bouselleg
lazeria	lazeria
zouc'het	soc'het
krankbigornenn	krankbigornenn
blac'hbian	plac'hvihan
Taol	taolia
rata	rata
glazeri	glazeri
gobius	gobius
diz	dis
chomadur	chomadur
veneSantMikel	Mikael
kotat	koataat
tiridintal	diridintal
bremag	bremaik
pitouilh	pitouilh
goenv	gwevn
peghapeg	peghapeg
merd'amdoustek	mardandoustik
blank	blank
ehoarh	begad
andona	andona
voalgaozeal	gwallgaozeal
faomunud	favmunut
fran	fran
elaktaladeu	talad
chafot	chafod
intanvezet	intavezet
avnfianskaer	avenefias
forbanet	forbannet
armad	armead
barbilimet	barbilimet
berrentez	berrentez
cource	koulz
argordennad	kordennad
diharjan	diharja
aziadost	diadost
distambouc'h	distambouc'h
Floderez	floderez
daonenn	daonenn
urbeluren	pelurenn
bourubourlu	bouruz
fosfat	fosfat
kaotigell	kaotier
Yanngatou	Katou
urgokelennad	kokellennad
baillad	bailhad
rizen	rizenn
anderzhiennfoll	terzhiennfoll
digor	digor
gwerc'h	gwerc'h
braebr	brae
diwriennet	diwriziennet
kas	kas
lormor	lormor
Mardandero	derv
silhasil	silhasil
dic'hlud	dic'hlud
chigarderez	chigarderezh
meuread	meuread
enoeaz	aez
ochakihagotichaki	chaokatchaokachaoki
askelleg	askelleg
Tonerdedie	tonerdedie
favaj	favaj
moulleged	moulleg
remmkalon	remmkalon
baotrenados	paotrenadoz
debret	debret
lalaig	lallaik
kouskae	kouskaez
aadvouskomze	advouskomz
bernwarvern	bernwarvern
zet	aezet
varnij	warnij
traplogod	traplogod
c'horadur	goradur
iberek	iberek
torch	torch
azilkaer	sil
halern	gwalarni
astlap	stlap
bara	para
distouret	distoura
coll	koll
barrasen	barrasenn
torgennek	torgennek
salmein	salmi
divreddifred	divred
droioukamm	trogamm
gorklunieu	kornklun
erbarezon	parezon
weledi	goueledi
klaskeribinou	ribin
Teuill	teuilh
emeusgreateuntourounad	tourounad
Romantelerien	romanteler
streujaj	strouezhaj
lokeres	lonkerezh
primhaprim	primhaprim
stol	stol
pich	pich
aetdaziavaezbro	diavaezbro
ogejet	ogedet
treboulereh	treboulerezh
guenojennou	gwenodenn
Fidadouenn	fidadouenn
pit	pit
yaouankizou	yaouankizo
eskeudse	eskeud
hantolrbrhek	brec'hek
skoaz	pennskoaz
rizennou	rizenn
estonkas	stonka
Kakouz	kakous
obananez	bananezenn
hoc'hunan	hoc'hunan
arForn	Forn
peuzpostek	peuzpostek
Garenni	garenni
eskummunuget	eskumunuget
diavizet	diavizet
abaadeu	pavad
chigoter	sigoter
dreizad	drezad
bannkroz	bannkroaz
c'houzienna	gouzienna
sznek	saoznek
keltiek	keltiekkeltek
adrojouez	adreuzjouadreuzo
sierj	sierj
enemzismantri	dismantradismantridismantr
koeffklos	koefkloz
diskennbriz	diskennpriz
tatoui	tatoui
warnij	warnij
azamserras	damserri
kolladennet	kolladenni
petore	petore
digompez	digompez
beurenoz	beurenoz
pempennein	pempenni
profezet	profezi
arC'horriganed	korrigan
brochen	brochenn
digivich	digivij
barr	barrliva
fourchetat	fourchetat
Liganaj	liganaj
goabehrs	goap
ravoder	ravoder
asantamant	asantamant
distraket	distraket
gouskmintin	kouskmintin
perc'hellesesgouz	porc'hellez
piano	piano
melc'hod	melc'hwed
kontristet	kontrista
diempennet	diempennet
frouezenn	frouezhenn
eunan	eunan
gobeu	gobo
Intanet	entanet
Slovakia	Slovakia
Pevarenn	pevarenn
norvejiat	norvejiat
ledanentez	ledanentez
tourtan	tourtan
eundrinkenn	trinkenn
selaouerien	selaouer
ezeasegouez	gouez
arvagn	magn
zuilha	suilhasuilhi
vourdinket	bourda
Diroufenna	diroufenna
kosennkosenno	kosenn
avilvern	avilvern
adreuzhagahed	adreuzhagahed
breil	brec'hkarr
lochet	locha
warvetenebeut	warvetenebeut
yunehemb	yunayuniyun
Sentoriou	sentorio
choatri	choatri
peurdismantret	peurzismantri
Perwenaniz	Perwenaniz
peuzstrujuz	peuzstrujus
toget	toget
minouredplouz	minorplouz
echintre	chintra
dilogereh	dilojerezh
peuzhenvel	peuzhevel
mleskern	meleskern
rannad	rannad
barodenn	barodenn
vauchal	baochal
Bleviniz	Pleviniz
ac'hlasvezas	glazvezi
divomet	divoemi
istrimant	istrimant
peurvadelezus	peurvadelezhus
torea	torea
diskrap	diskrabadiskrabatdiskrab
raouitel	raouitell
bouc'haboc'ha	bouc'ha
eskobiez	eskobiezh
vouchen	mouchenn
izelvez	izelvezh
maeze	maez
begadet	begadet
zonerezed	sonerez
ed	gaiez
stlibika	stlibika
endouadel	touadell
suhuniad	sizhuniad
milboulc'huik	boulc'huig
geuneudmed	keuneudmed
digraket	digraket
drvaz	drevaze
dihoustek	dic'houstek
dohta	diouzhta
lipad	lipad
logell	logell
Diguza	diguzhadiguzhidiguzh
gouezelekaat	gouezelekaat
barogw	barvgwezbarvargwez
vennant	mennentez
rgrandision	krandision
hungareg	hungareg
tibank	tibank
peuztonius	peuztonius
felc'hek	felc'hek
Ramadan	ramadan
loloein	loloi
zisklipa	disklipa
dic'hlan	dic'hlan
kledouren	kledourenn
studiaden	studiadenn
gwano	gwano
sprumanter	spurmanti
dizornet	dizornadizornia
freuzavareolenn	freuzafreuziatfreuzi
Breinpezel	brein
touller	touller
karoerc'hkarverc'h	karverc'h
letonen	letonenn
neziarfleueinket	diarfleui
dreustelio	treustell
kaoutegabestr	kabestr
droukfazi	droukfazi
hivizen	hivizenn
fronden	frondenn
Daklao	daklakdaklao
resti	resti
Amaer	amaer
glochedet	klochedet
frigaset	frigaset
taskagner	taskagner
deknikel	teknikel
etermone	termona
Cheun	Cheun
urbalad	palad
kouivraterion	kouevrataer
dawenelegenn	gwenelegenn
chilopenn	chilopenn
Japon	Japon
moalr	mouaraer
kadoriokloz	kadorgloz
dramc'houlou	damc'houlo
spouronet	spouronet
rumoug	ruzmoug
dizinouussoc'h	dizenoes
adakado	adakado
klac'het	klac'het
forc'hata	forc'hata
talkein	talkein
gaoutdiez	diaez
oajedek	oadedek
lanfre	lanfre
koulz	koulz
iou	goaf
mardandoustenn	mardandoustenn
ressordeu	resort
arvargiez	margiezh
roamid'in	ami
Chourgana	sourgana
dielc'het	dielc'hetdihelc'het
perachu	peurechu
parapri	paraplu
ziroufennahedeot	diroufenna
Pakadennet	pakadenni
digompez	digompez
ampartaat	ampartaat
divez	diwezh
botteu	bot
flodr	floder
BankToser	tosel
bronnet	bronnet
goullanter	goullonder
treinchpik	trachpig
arpeurvrasa	peurvrasa
dishet	disec'het
savas	savas
ridgoed	redgwad
Poac'h	poac'h
plastrer	plastrer
meldivellet	melldivelli
Pegenn	pegenn
indigo	indigo
bidanig	bidan
klouka	klouka
danjer	dajer
Meingailhes	maenkailhez
rizennou	rizenn
milinesken	milinheskenn
bourjinerez	bourjinerezh
tefouraj	touforaj
Viviana	Viviana
roufennet	roufennet
pur	pur
lafez	lavrez
urc'houroc'hell	gouroc'hell
diblas	diblas
arc'heur	keur
dizeureuji	dizeuredi
dinerh	dinerzh
kotilh	kotilh
agetan	agenta
bivinzson	saesonsaezon
healanaddiveza	analad
dihlozein	dic'hloaza
voularzi	moularziboularzi
ezaoui	ezevi
goulloder	goulloder
chachploused	chasplouzenn
morhan	moranv
Damnac'hnevin	damnac'hdavin
Amzeri	amzeri
moustig	moustig
doulla	toulla
dirason	dirason
merag	merak
digroz	digroz
diharak	diharak
diveuz	diveuz
Advurarvur	advur
didrubuilhan	didrubuilha
abelkent	abellkent
neharpfeouto	harpaharpi
arpeurliesan	peurliesa
toka	toga
chaltapiz	chaltapis
nounez	nounez
jiminas	jiminas
skrivadenno	skrivadenn
dismantein	dismantradismantridismantr
diranj	diraj
jibosereh	jiboeserezh
digumun	digumun
doniet	toniet
diskarerbaro	diskarerbarv
distokein	distokadistoki
c'hoariellerez	c'hoariellerezh
kac'herergwasked	kac'her
lip	lip
skoempaat	skoempaat
ouln	goulenn
grosoc'h	gros
baltek	baltek
ainou	eno
ezelet	ezelet
dic'hloaz	dic'hloaz
damstalet	damstalet
pinijennus	pinijennus
taperien	taper
warmagorre	gorre
ziaket	diaket
dourista	tourista
karigelladou	karrigellad
ma'skavet	marskavi
gwignqalhadiwignqal	diwinkal
saourapl	saourapl
selltro	selltro
asiedad	asiedadasietad
Lichet	lichet
hemolc'h	hemolc'h
kenetrezo	kenetre
urvlaz	blaz
graia	gravia
pichos	pichos
tivohalein	divouc'hala
riblet	riblet
dournet	dornet
zirevi	direvi
Bnezet	benezet
diahelet	diahelet
arvapeur	bapeur
toulour	touller
kelaneu	kelan
Suhuniadeu	sizhuniad
kanived	kanifl
dero	derv
postomin	postmin
sukraj	sukraj
diredon	diredien
Placqrien	plaker
bagou	bag
duta	tuta
barrez	barrezh
peuk	peuk
hollgaer	hollgaer
mouroueller	bouroueller
azvogueryou	azvoger
rakskrid	rakskrid
ambrudi	ambleudi
astroll	stroll
KochVara	kochvara
pouellus	poellus
levenedigez	levenedigezh
aleizkorzen	aleizhkorzenn
abeurbado	peurbadout
azodreostigenn	stigenn
pellskriva	pellskriva
devezhiado	devezhiad
vem	meme
disorb	disorb
plen	plaen
ahantr	ahanter
astroll	stroll
hailhoset	hailhoset
urgonistellad	kostinellad
eurwrac'higkoz	gwrac'higkozh
diswalc'het	disgwalc'het
gwelabl	gwelapl
braeougoullo	brae
kasaet	kasaet
logangnan	logagnan
guchaden	kuzhiadenn
douarbeuzel	douarbeuzel
Brrrou	brrrou
Kalviniat	kalvinatkalviniat
abempenno	abempenno
choaziset	choazisa
kornokoc'h	kornk
emwalc'hadur	emwalc'hadur
glanch	glach
kertrius	kerterius
askelldilig	askelldilig
daoubleget	daoubleget
darempredour	darempreder
homeopatiezh	homeopatiezh
digontam	digontamm
temtasion	temptasion
dagania	kania
tempsiouspered	temzspered
boulzeiz	boulseiz
ispridet	ispridet
saladeu	salead
vouched	mouched
trec'hwar	trec'h
zourjostr	jostr
eurgledourenn	kledourenn
n'humchifesket	chifachifalchifi
lostregen	lustrugenn
diboell	diboell
tourchal	tourtaltourta
poldoket	poldoka
guelderuel	gwelldrewell
erbaillarded	pailhard
Plaen	plaen
engroez	engroez
Krign	krign
Mailh	mailh
diliet	dilivet
agreiz	agreiz
rantikou	rantiko
Kraia	gravia
Bourgeu	bourgeu
glaskerioneur	klaskeraour
satanazet	satanazet
ahaoleg	ac'haolekac'haoliek
bleudlouzou	bleudlouzo
adrohir	adrohir
afutellaj	afutellaj
avad	avat
kwita	kuita
nehan	nevezhav
displantryen	displanter
Groamlandigedon	landigedon
kaseet	kasaet
debonjouri	debojouri
boulc'ha	polc'hi
nijadenn	nijadenn
ambludi	ambleudi
Moummoummoum	moum
touneta	touneta
lalaig	lallaik
eobreinget	brein
bugelel	bugelel
tanshatans	tashatas
teriontourian	despederdespetour
avieler	avieler
ardigelled	ardigell
rouzig	rouzig
poan	poan
andellad	andellad
dishra	dishriadishra
adolpadigeu	adolpad(ig)o
bourdr	bourder
bignotat	pignotat
chalfaud	chafod
aocherien	aocher
Experians	eksperias
chop	chop
c'houezar	foulet
tilanzr	dileanezi
fruket	fruget
emoberiusted	emoberiusted
hadtapout	adtapout
digrechanet	digristenet
obereundispakwar	dispak
Ploulec'hiz	Ploulec'hiz
gomers	komers
pinijenn	pinijenn
ewallskojont	gwallskei
ouka	oueka
bosuadel	bosuadell
dizeskvar	dizesk
amzigor	amzigor
mangrellet	magrellet
abad	abad
Kki	kki
kevnidenn	gavnienna
kokolorig	kokolorig
endeshersetgeton	hersalhersahersi
parmailh	parmailh
flers	flers
Polua	poluapolui
mourn	mourn
api	aspi
Rannyezhouriezh	rannyezhouriezh
morebkoz	moerebkozh
aradiez	diaez
gavelbadiziant	kavellbadeziant
c'houezadur	c'hwezadur
suilhus	suilhus
kalipezenn	kalipezenn
benigedein	binnigedi
Toneilhe	toneilhe
munuzereh	munuzerezh
disou	dis
soublienn	soublien
siella	siellasielli
savodennou	savadenn
Dalc'helez	dalc'helezh
c'houibez	c'hwibez
lanngibin	lanngibin
reoli	reoli
erezi	ereziereza
urc'hac'herdiaes	kac'her
bourda	bourda
digor	digor
Judazen	yudazenn
falzaoten	falzaotenn
rahkoed	razhkoad
kafr	kafr
Ploulec'hiz	Ploulec'hiz
damsklr	damsklaer
c'hw'istim	c'hwistim
fumi	fumafumifumal
ranndu	ranndud
sunveziad	sizhunvezhiad
fidezouar	fidezouar
medesinloened	medisinloened
provaseg	provaseg
divreton	divreton
gobrbourus	bourrus
aguh	aguzhkaer
arc'hmliataa	amheuliata
urvourbouten	bourboutenn
dramignan	dramignan
avalpato	avalpato
ac'haoliad	gaoliad
laonenndrech	lavnenndrech
merzerentiet	merzherintia
treusteltreusteul	treustell
Jozefin	Jozefin
rioterez	rioterezh
dic'hailhou	dic'hailhou
fredennig	fredenn
agandad	kantad
bokedoukoraiz	bokedkoraiz
difardet	difarda
brein	brein
ed	inged
aunvanganto	aunvan
bengouleu	penngoulo
skuizlazet	lazhet
Blouarediz	Plouarediz
abln	plaen
dramaek	dramaek
grabotennigued	krabotennig
uslard	uslard
gwidal	gwidal
tounetaerion	tounetaer
dibluennet	dibluenni
arglanvourien	klavour
Asted	asteud
charawi	charaoui
sec'het	sec'het
skars	skars
astribill	astribilh
potarnaj	potarnaj
o	kouch
koriet	koria
Daon	daon
Rekeinsein	rekisi
asederra	sederaat
foratour	foarataer
askana	askana
Che	se
barch	parch
difetet	difetet
steuziadur	steuziadur
dourbeu	beuz
hentad	hentad
'ta	'ta
ion	riser
blank	blank
padreuze	treuzitreuza
blojo	blod
mesou	maez
bepenamzer	amzer
baillad	bailhad
aremen	aremenn
Ae	ae
arveinc'hris	maengris
dibolod	dibouloud
vennant	mennentez
gadorliz	kadorlez
skanvad	skavaat
paterdomm	pater
sclizennei	sklisennasklisenni
reoli	reoli
gwasket	gwasket
kerseet	kerseet
bersondean	persondean
korfadurel	korfadurel
hollc'halloudec	hollc'halloudeg
o	god
dizalc'h	dizalc'h
tiredunani	tiredunani
disakr	disakr
euzeuz	uz
ion	evner
mlasion	meulasion
broDreger	BroDreger
enemavantur	avanturi
Mitennek	mitennek
nneu	chupenn
haret	haraoi
Urbizhardenn	pizhardenn
Bini	beni
plen	plaen
oberouemzikour	emsikour
ledanded	ledanded
urC'haergenou	kaergeno
streignadeu	streiniad
zellerien	seller
dihranet	dic'hreuniet
nu	nevez
anterwisk	hanterwisk
sigur	esigur
urgac'hadennyar	kac'hadennyar
koanta	koant
propoliz	propoliz
arboellet	arboellet
foeltrbouzello	foeltrbouzello
manteliet	mantelliet
didrevadenna	didrevadenni
priprat	priprad
azibouez	dibouez
krazlard	krazlard
abafet	abafet
dizuah	dizoazh
lorbour	lorber
klenk	klenk
vilonaj	vilonaj
mes	maez
skoljet	skorja
Milat	milad
erviridig	birvidig
hesonezh	hesoniezh
nevezdifluket	difluket
distrap	distrap
anaozi	anoazhi
glannaat	glannaat
burobutun	burevbutun
brein	brein
avalpatatez	avalpatatez
frich	frich
bervus	bervus
flip	flip
dihaill	dic'hailh
piano	piano
IaouBask	YaouBaskYaouFask
urupailh	urupailh
glokerez	klokerez
neviopus	nevbus
oaziri	oaziri
hevelpoch	poch
uz	uz
mleris	meuleris
erjennet	erjennat
mardoustik	mardoustik
asdeut	azdeuet
o	binot
chetet	chedet
rabaniwar	rabani
Fidam	fidam
eeunhageeun	eeunhageeun
pazein	pazi
kutuilhet	kutuilhet
hulac'het	uloc'het
touchhatouch	touchhatouch
sklisaoui	sklisaoui
dilesidy	dileziad
imbouderimboudour	imbouder
millizout	millizout
enemzantelaat	santelaat
digarantez	digarantez
distorlok	distorlok
Lut'naj	lutunaj
kevnita	kevnita
meneztan	meneztan
garanet	garanagarani
demvorn	damvorn
Ao	Ao
melchen	melchon
vombardi	bombardi
maenbadez	maenbadez
astellatat	astellata
zejanal	dejanaldejani
likozaj	likoezaj
soudek	soudek
arhflutigeu	flutigo
saill	sailh
bailhad	bailhad
buch	buch
Yon	Yon
satouilhat	satouilhat
urc'harzad	garzhadgarzhiad
nako	naiko
bernioumor	bernmor
rarangalonambeuskmret	ranngalon
hurusal	hurusathurusal
poullet	poullet
c'hrotenn	krotenn
led	led
Akre	akre
disudardet	disoudardadisoudardi
skoazet	skoazet
brizvelen	brizhvelen
landruillenn	landruilhenn
bninou	eno
stamouzet	stamouzet
torch	torch
izelt	izelaat
adoniet	andoniet
abardaeznoz	abardaeznoz
amgredoniez	amgredoniezh
odevi	odivi
sinema	sinema
harzenni	garzenni
'z	z'
frifurch	furch
fichet	fichet
goudjere	gougerc'h
ster	str
kouskat	kouskaat
baramechen	mouchenn
Defrejou	defrejo
morzennet	morzennet
kompez	kompez
asprena	asprena
touezier	touecher
dilovrein	dilovri
depech	depech
breinadur	breinadur
druz	druz
Taflak	taflak
bator'let	batorellet
arbennsturienn	pennsturienn
porzhhouarn	porzhhouarn
kroajet	kroazietkroazet
croza	krozalkroza
boufam	boufam
poac'h	poazh
arengenn	arenkenn
orjalspernek	orjalspernek
aino	aeno
didrouzet	didrouzet
neventi	nevezinti
goallali	gwallali
lustrugen	lustrugenn
Kouricher	kouricher
dic'hoarzet	dic'hoarzhet
urganden	kantenn
drewap	goap
dinac'h	dinac'h
zizouelez	dizoueelezh
blazvlaz	blaz
fumi	fumafumifumal
brotestant	protestant
krugigdouar	krugigdouar
astummgant	astummgant
minotenneu	minotenn
baska	paska
adkarout	adkarout
mendro	mendro
arhul	arwele
eurc'hempenn	kempenn
leskuz	leskus
malisennou	malizenn
drag	drag
bourjinez	bourjinez
regarherz	regarzherez
glasktrabas	trabas
gerentaj	kerentaj
tiezkolo	tikolo
arc'harrboutin	karrboutin
kouifeupln	koefplaen
Soublienn	soublien
promesaou	promesa
amseriou	amzer
spoeset	spoeset
gros	gros
linseret	liselet
hengoun	hengoun
dremsellet	dremmsellout
Muloc'het	muloc'het
Troaze	troaze
brispolite	prespolite
'maese	maez
medita	medita
aguhkaer	aguzhkaer
provansek	provaseg
eurbolez	polez
choc'h	choc'h
barskuill	barrskuilh
darbodet	darbodi
sorsellerez	sorsellerezh
Ramadan	ramadan
ed	bog
zigablusted	digablusted
kad	kad
afallasdezhi	fellelfelloutfallout
disanve	dizanavez
Meskailhez	meskailhez
Bepeilpennet	pebeilpenni
ptredtoull	paotrtoull
pezhiad	pezhiadpezhad
drederenn	trederenn
chourinet	chourinet
echuadenn	echuadenn
dilorc'ha	dilorc'ha
gouelprenestr	gouelbrenestr
diskranet	disgreunet
charitellet	jaritellet
ormelan	ourmela
eurbompidel	pompinell
braobras	bravbras
vennant	mennentez
distoladen	distaoladenn
tudadrabas	trabas
pourteil	pourteil
ober	furch
fric'hweza	fric'hwesha
spinac'ha	spinac'haspinac'hi
moujourden	mouzourdenn
Agetan	agenta
oldud	oldud
Tuta	tuta
falc'huneg	falc'huneg
eurgompagnunez	kompagnunezh
ereer	ereer
gradvad	gradvat
beboret	beboar
paeroni	paeroni
kenetrez'ho	kenetre
blankon	plankon
kalmchaok	kalmchok
astennet	astennet
scod	skod
liant	liant
Avieler	avieler
dabichoneta	pichoneta
urhuiziegeh	gwiziegezh
vignoneh	mignonezh
loukez	loukes
breser	bresermein
keinhakein	keinhakein
balouard	balouard
agriforz	agriforzh
politik	politik
diblg	dibleg
eosterez	eosterezh
rouzenn	rouzenn
hual	hual
digorder	digorder
difuilha	difuilha
dironjereh	dirojerezh
hoper	hopernoz
fevaren	pevarenn
puket	puket
atil	atil
vezinpense	bezhinpese
wardre	wardrev
kraon	kraomor
zabatierenn	tabatierenn
Vaganein	fagani
kostabannou	kostabanno
bannou	bannkroaz
anDaolZantel	taolsantel
sedrenn	sedrenn
oberhefennmouz	mouzh
astalgostez	astalgostez
gweriou	gwerio
erc'hreierhouarn	kroghouarn
brezonega	brezhonega
saill	sailh
toullhend	hent
zigolvennat	digolvennat
mallestouen	mallozhtouenn
Kernmabuoc'h	kernmabuoc'h
poullouglaou	poullglaou
c'hasaou	kasao
chouchen	souchenn
Teologiezh	teologiezh
briz	briz
lorgennek	lorgennek
feur	feur
pere	pere
Fain	fain
astummgant	astummgant
dizispign	dizispign
cheche	cheche
reh	reizh
ieu	reper
traouechou	traouezio
garchen	garchen
koukouat	koukouat
ehadgwelin	adwelout
kouter	kouter
GoueledKerne	GoueledKernev
trkaer	trekaer
mardoundouchoun	mardondechon
diskoilhan	diskoilha
abennkrak	abennkrak
astokaswardreuzoutan	wardreuz
spurmantein	spurmanti
adroc'htranch	troc'htrach
lezdavond	lezdavont
Trapebtra	trapeptra
Damenavo	damen
nerzkaloun	nerzhkalon
erhargouilhen	gargouilhenn
Labaskenn	labaskenn
kelo	kelokelav
toc'htoc'h	toc'h
humvellein	mellamelli
andouvo	andouv
zongalv	songalv
digaset	degasdegasi
pluerc'h	pluerc'h
koutigkoutig	koutik
chajelladchagellad	chagellad
Maes	maez
Miaou	miaou
kildroen	kildroenn
dispi	dispi
adperc'henni	adperc'henni
laezti	laezhdilaezhti
moujourden	mouzourdenn
toulkeuneudok	toullkeuneudeg
parstrak	parstrak
aliein	aliaalii
gwezennvezv	gwezbezv
krigipaludenn	paludenn
gwitaou	ergentaou
adstarda	adstarda
emweladenn	emweladenn
meinet	meinet
Sankrampoeh	sakrampouezh
hadtanva	adtava
NorzAmerika	Norzhamerika
roulerez	roulerezh
klenk	klenk
pignounkroz	pignonkroaz
z	nevez
vazegi	bazegabazegi
carton	karton
diskwizus	diskuizhus
adstudia	adstudia
abeurzall	aberzhall
bourc'hiz	bourc'hiz
didec'het	didec'het
fourenn	fourenn
soviedat	soviedat
poket	poket
rouig	roueig
begchopin	begchopin
galeounerien	galeoner
duheuill	duheuilh
Lomanaucher	aocher
landerni	landerni
goureontr	goureontr
kourz	koulz
chouchet	souchet
Keutkeut	keut
azizorne	dizornadizornia
difeilleni	difeilhenni
dijastre	dichastre
ampoezonnet	ampoezonet
amboubal	amboubal
komzplaen	komzplaen
Setuperag	setu
Kerzinen	kerzhinenn
skiltek	skiltekskiltrek
fidezouchen	fidezouchenn
gouarnouryan	gouarner
kamziou	kamz
loufog	loufek
drougarma	drougarmaen
Charingourd	charingourd
azougarveach	azougarwezh
eurhaznoz	kazhnoz
divroidi	divroaddivroiad
spegus	spegus
dizec'het	disec'het
koadbuch	koadbuch
beurzeski	peurzeski
undavarnourz	tavarnourez
umsantlat	santelaat
mestrezskol	mestrezskol
eurc'haerbez	kaerbezh
avostad	avostad
digelionour	digeliener
koffmezer	koefmezher
roz	roz
bananez	bananez
logell	logell
tapizryen	tapiser
saotr	saotr
drailh	drailh
skduet	skaoduet
flech	flech
treusplantet	treuzplantet
tenneris	tenneris
Berjinez	berjinez
agetanpenn	agentapenn
Chabo	chabo
zismantr	dismantradismantridismantr
Livna	livna
eurblanchonenn	plachonenn
harziad	garzhadgarzhiad
ampusturi	ampusturi
morjinerez	morjinerezh
diandella	diandella
hanternozel	hanternozel
ollbur	hollbur
krozadennou	krozadenn
iahoni	yac'honi
kkelkelk	kekelekeleke
ebena	ebena
divreton	divreton
peuraj	peuraj
bohellegenned	boc'hellegenn
menon	menon
Ragoplaen	plaen
tiazeul	tiazeul
fouterdidi	foutre
enebarzh	enebwerzh
sigur	esigur
varzoug	warzoug
harpa	harpaharpi
Taran	taran
koulz	koulzbloaz
begmimi	mimi
nolenneu	nouelenn
Gerz	gerz
satouilhat	satouilhat
friankal	friankal
anou	eno
divlenchet	divlechet
brederenn	prederenn
karg	karg
a	goap
skip	skip
steredenna	steredennisteredenna
Malamantet	malamantet
efichfiche	fichfichal
dreeno	eno
difoultre	difoutredifoultre
dinec'hi	dinec'hi
moust	moust
frai	frai
dirr	direvr
dejanei	dejanaldejani
feizd'amboutou	feizda'mboto
savetwaregiberno	kiberno
sitronadez	sitronadez
bannokroaz	bannkroaz
dibennerez	dibennerez
tilh	tilh
dievesiant	dievezhiant
begelbolz	begelbolz
flip	flip
ahirded	ahirded
labourajdouar	labourajdouar
treuzvor	treuzvor
druhkat	truekaat
maniok	maniok
diribanz	dirabas
salad	salead
zisvoneur	disvoneur
dalia	talia
peurderri	peurderri
pendrabi	penndrabi
meneztan	meneztan
Bezaechalda	chal
sekourgeto	sikoursikouri
Chifal	chifachifalchifi
berlobi	berlobibrelobi
alernereh	gwalarnerezh
goafer	goafer
dichifein	dichifi
o	posin
Brochenn	brochenn
levrigfamilh	levrigfamilh
brinibihan	branvihan
eurvlazenn	blazenn
evnporz	evnporzh
Kouzi	kouzi
femelenn	femelenn
Overennvihana	merennvihana
benviajet	benviajet
sec'henned	sec'henn
maleu	mal
breinadur	breinadur
klevedargear	klevedargr
chilz	chilaezh
aziarbremen	azirbrema
dambonr	damboner
legrest	legestr
Kaskalat	kaskalat
Karabot	karabod
obertonhatroen	troen
tintet	tintaltinta
guivt	gwiv
eurc'hachet	kached
henskridou	henskrid
hantervezh	hantervezh
arbenedouriez	penedouriezh
boemet	boemet
bichonglaou	pichonglaou
pausenneu	pozenn
frikreien	frikreien
tlgraf	telegraf
leunbloup	leunbloup
diaozet	diaozet
boubou	boubou
diskurpuill	diskorpul
gwennhollwisket	gwennhollwisket
digor	digor
FleurSantJozef	fleursantJozef
hevag	hevag
Digoramzr	digoramzer
borb	borb
alkoll	alkool
moukled	moukled
Abad	abad
eurbec'herez	pec'herez
ijinenn	ijinenn
Taran	taran
stoubec	avalstoubek
mizveziou	mizvezh
anderzhiennduilh	terzhiennduilh
valarjea	meurlarjezameurlarjezi
prada	prada
stalikenn	stalikenn
tommadennou	tommadenn
boz	poz
houbet	houbet
divreiza	divreizha
dismantamzr	dismantradismantridismantr
flatat	flatealflateat
kalavet	kalavret
diyalc'het	diyalc'ha
divountoun	divounton
adaet	advont
straker	straker
beurlek	beurlek
divastar	divastar
Braveuri	braviri
gourieo	gouryev
rusven	ruzwenn
matifrink	difrinka
papelod	papelod
ludueg	ludueg
eostgwenn	eostgwenn
ahetet	ahedet
digasteh	digastezh
rizeg	rizeg
bigorneter	bigornetaer
lunvez	lunvezh
mahet	mac'het
Nadoziouanavel	nadozavel
frizrybnu	friz
pilpazat	pilpazat
modkr	modkr
truilhet	truilhet
enemzisrann	disrannadisrann
pennadskrid	pennadskrid
anterdrugarekt	hanterdrugarekaat
gwigour	gwigour
houjard	goujard
garlantezban	garlantezban
Korniachou	korniajo
drezil	sil
yac'hpilh	yac'hpilh
eurjilinn	silienn
rejanti	rejanti
Lijennet	lizennet
pividet	pibida
ivantoria	invantoriivantoria
egalleg	galleg
laezbihan	laezhbihan
bitaouat	pitaouapitaouat
dirodell	dirodell
arneuek	arnevek
skouarnet	skouarnet
machete	machete
dispreget	dispregi
larerz	lavarer
nevez	nevezflamm
eterme	termaltermat
ekorzigoraz	kornzigeri
choberdet	choberdet
trinqEostic	trenkeostek
helpennet	helpennhelpenni
livennet	livennet
vugulz	bugulez
kulturel	kulturel
Croaz	kroaz
tortu	tortev
digeuzia	digeuzia
luc'hachi	luc'haji
vedika	meudika
gwezennblatan	platan
lodein	lodalodi
skora	skora
arc'hlazur	glazur
mouson	mouson
Annamited	Annamit
KanhaDiskan	kanhadiskan
aziadost	aziadost
'nemchakat	chaokatchaokachaoki
digeuz	digeuz
lipadeu	lipad
berloet	berloat
adozet	nadozi
kouchet	kouchet
pailhokerdour	pailhokerdour
bir	bir
kastra	kastra
VikelMirer	vikelmirer
warmagorre	gorre
dilouiaj	diluziaj
brezed	brezet
driv	driv
arc'hlik	klik
Diarc'henflipez	flipes
KokelinKokelokKokelinerHog	kokelinkokelokkokelinarc'hog
streuveul	streuvell
Aboz	aboz
Arbaotredaod	paotraod
dibl	dible
houpal	hopalhopahopi
darzegennat	darzegennat
Chodorella	chodorella
adreuzelle	treuzella
anaez	anaes
nasket	nasket
apoueilh	apoueilh
menmouilh	maenmouilh
Gallegsaout	galleg
damruian	damruzia
marvaillou	marvailh
ruskennek	ruskennek
alonkadou	alonkado
bnadures	benadurezh
dishost	dishost
didrec'h	didrec'h
lenn	lenn
treuniet	troc'holiet
aotervraz	aoter
kroazedo	kroazed
oranein	orwani
adrs	tres
faegaegeg	faegaegaeg
begad	begad
sankrampoh	sakrampouezh
lustrugen	lustrugenn
Melkerna	melkerna
blojo	blod
otoubrozec	brozhek
adorerz	adorerez
dilabour	dilabour
tronket	tronket
Na'vidse	evitse
Finat	finaat
Naziezh	naziezh
raskenn	rasklenn
saotret	saotret
diroudenn	diroudenn
lztourgouilhet	tourgouilhet
amlez	amlez
amzerservij	amzer
ebadeved'in	ebat
dalereh	daleerezh
mezevennet	mezevennet
dreistnatur	dreistnatur
puchet	puchet
pennbouellet	pennbouzelli
diatach	diatach
poaniouspered	poanspered
azotennetarsponterezigdioutan	sponterezig
Sator	sator
tufuek	tufektufevek
Dic'hoi	dic'hoi
Stoklostou	stoklosto
klenvetarc'housket	klevedarc'housked
hadwelet	adwelout
luhek	luc'hek
disvantet	disvantet
shour	sec'hor
vaganet	vaganet
abeurc'hounezo	peurc'hounit
bag	bag
rabankenno	rabankenn
aventgant	avent
egarzegen	garzegennat
ahenema	ac'halemaac'hanema
touneta	touneta
asiedad	asiedadasietad
freantiz	frevantiz
entnet	entanet
aledkorf	aledkorf
gwano	gwano
argarvangalon	karvangalon
rec'hi	rec'hi
edsablied	sablienn
dallput	dallput
marvad	moarvat
peilhermor	peilhermor
tigwerz	tigwerzh
Daonchet	daonchet
Grounn	gronn
unaniez	unaniezh
Enkrezet	enkrezet
dizro	dizro
trankad	trankad
prespolite	prespolite
ziraoskla	diraoskla
diraz	diraz
jina	china
modernaat	modernaat
boulc'het	boulc'het
dilabour	dilabour
Fidedoulle	fidedoulle
damlaouen	damlaouen
standilhoni	standilhoni
abeurbilas	peurbila
adonnad	adovaat
adprometet	adprometi
andanaven	tanavenn
Bidiez	bidiez
dudius	dudius
leurrauk	leurraok
Marc'hpaotr	marc'hpaotr
tifuz	tifuz
kembreat	kembreat
ribardellet	ribardellat
garnein	karni
Primad	primad
Bedibedonbedibedan	bedibedonbedibedan
julgerc'h	jilgerc'h
malaria	malaria
larour	lavarer
arc'habanou	kabanou
moalet	moala
pohonour	poc'honer
kannerzednoz	kannereznoz
Loeiza	Loeiza
atroprez	atroperez
leurenn	leurenn
diforh	diforc'hidiforc'hadiforc'h
eurvapeur	bapeur
luil	luil
dourmeur	dourmeur
kenstrivadegou	kenstrivadeg
'ta	'ta
demc'haou	damc'haou
disarmadeg	dizarmadeg
teoard	tevard
Porc'hellegezh	porc'hellegez
torfeterez	torfedourez
enemvraka	braka
urvrozhenn	brozhenn
gwadaval	gwadaval(o)
skluzerien	skluzierskluzer
avourc'homze	mouskomz
Mougerien	mouger
truajou	truaj
bleuniet	bleuniet
dihuennekat	dic'hwenekaat
madelehus	madelezhus
brakognach	brakonajbrakoniaj
eddragonez	dragonezenn
goueledi	goueledi
Andoniet	andoniet
bekilh	bekilh
diharag	diharak
charnelein	charneli
biskornloar	biskornloar
erc'hantin	kantin
SantNikolaz	santNikolaz
Brezonegomp	brezhonega
machine	machina
didrec'h	didrec'h
galvedigez	galvidigezh
yezaduria	yezhaduri
auntu	auntu
hadvew	advev
begad	begad
undarinenn	tarinenn
pastezennou	pastezenn
tortouzek	tortouzek
skraingnet	skragnet
eurVaribegaraok	begaraok
tieskern	tieskern
poan	poan
touell	touell
arvrag	brag
Badaouina	badaouina
'rc'hannadour	kannadour
dirollereh	dirollerezh
amgreden	amgredenn
voulc'het	boulc'het
egoreanenvou	gorre
lodennvar	lodennvarr
urc'houblad	koublad
Oberchouraouda	chour
rentakont	rentakont
jargilh	jargilh
eurvarodenn	barodenn
biskornet	beskornet
leozenna	leozennaleozenni
Bakonik	bakonik
bleinchan	blech
gonkouri	konkouri
Krankedmordivino	krankmordivino
prsor	presouer
gweleoukevnid	gwelekevnid
agourceu	koulz
adgwel	adwel
vreton	breton
poangalon	poangalon
amled	amled
aontachet	aontachet
Kammedhakammed	kammed
maizelaomp	izelaat
urVarifaoutenn	faoutenn
divrezonek	divrezhoneg
seit	seit
mintinvez	mintinvezh
dervek	dervek
warandis	dis
arC'hozhVarc'had	KozhVarc'had
leinter	leinaoter
amboubalkoz	amboubal
diblusket	diblusket
enemrei	rei
sardinereh	sardinaerezh
Daouzekved	daouzekvet
goasked	gwasket
daoublegerez	daoublegerezh
rafalidi	ravalidi
kefelegkeveleg	kefelegkoad
splanndr	splannder
asolvereh	absolverezh
skolat	skolaat
koustlet	klaoustreet
diliorzet	diliorzhet
mestrskolaer	mestrskolaer
krabanaouek	krabanaouek
maenkrampouez	maenkrampouezh
lastraou	lastrao
Kinset	kinset
paotredojakenn	paotrejakenn
neket'ta	'ta
teurk	teurk
divordan	divordadivordi
brein	brein
amvent	amvent
dizouar	dizouar
Kaskalat	kaskalat
varec'houlenn	goulenn
louedenn	louedenn
blejer	blejer
enemleua	laoua
dirod	dirod
gofezadur	kofezadur
andreuz	dreuz
luduc'hoalen	luduholen
korvigellet	korvigellet
brousta	brousta
c'houerventez	c'hwerventez
o	bosad
persondean	persondean
flipat	flipaflipatflipi
digeit	digeit
freuza	freuzafreuziatfreuzi
lala	lalla
diharak	diharak
digourachi	digouraji
amzer	amzer
reiz	reizh
Nijerez	nijerez
ingoulek	ingoulek
Uisanden	Visantenn
spegus	spegus
strakvourc'hiz	strakvourc'hiz
goujard	goujard
fubumoui	c'hwibumoui
bougret	bougre
toufad	toufad
tokribot	togribod
divouedet	divouedet
Diraset	dirasadirasidiras
charn	charn
keltiek	keltiekkeltek
keliengorilh	keliengorilh
gwadavalo	gwadaval(o)
kasenn	kasenn
bouta	pout
dadkaer	tadkaer
SantPever	SantPever
drop	drop
azeeh	azevezh
huizbrein	brein
didronpein	didrompladidrompli
ed	adren
lampraat	lampraat
labourerezdouar	labourerezhdouar
marc'hbez	marc'hbez
oens	oes
chiket	chiket
doubledichou	doubledichou
Paludenn	paludenn
s	as
divot	divot
renket	renket
satouilhat	satouilhat
frotaden	frotadenn
Ich	ich
lutuned	lutun
evezted	evezhded
davete	davete
klor	klor
guezkrenerez	gwezkrenerez
divolz	divolz
gaouyerez	gaouierezh
dervennek	dervennek
morhlas	morc'hlas
Dantifilouzenn	dantifilouzenn
malanjerek	malajerek
Tez	tez
Keusteudi	keusteuri
ion	sinour
standill	standilh
diffiennou	difienn
askelldro	askelldro
arimbisil	arimbisil
eusarret	red
gwabriol	gwabriol
charboter	chalboter
krahin	krac'hin
kalsoneukoed	kalson
firigellou	firigello
riad	euriad
ouilereh	gouelerezh
helpenni	helpennhelpenni
biciq	bisig
Amskanv	amskav
anemiz	anemiz
chapeledad	chapeledad
ovid	vit
tirilia	tirilia
vaos	vaos
strilhennou	strilhenno
skubachen	skubajenn
ed	bak
butunkarot	butunkarot
lahetbras	lazhet
chif	chif
eurc'hornmezen	kornmezenn
pennbaz	pennbazh
taranereh	taranerezh
Didrubuilhet	didrubuilha
trujetat	trujetat
eoriet	eoreteoriet
makaroni	makaroni
petore	petore
dawallhanoiou	gwallanv
kontellen	kontelleeun
lakaat	laikaat
bruskereh	bruskerezh
breizat	breizhat
arabadus	arabadus
eskantet	eskantet
krennhakras	krennhakras
dieuberien	dieuber
grilhedglas	grilhglas
spiterh	spiterh
divors	divors
diorren	diorren
fourgat	fourgat
argadorbrezeg	kadorbrezeg
rizek	rizek
arblaen	arblaen
blank	blank
baseadenni	paseadenni
hadsonj	adsoj
binijennus	pinijennus
sizunveziou	sizhunvezh
skinwelet	skinweli
balustr	balustr
tret	taeret
dev	tev
aezhennek	aezhennek
vrodiri	brodiri
mallohereh	mallozherezh
arc'hlanvour	klavour
tintalger	tintaltinta
tolzia	tolzia
chapeleda	chapeledachapeledichapeletat
bouedmir	mir
divorfil	divorfil
Fardellet	fardellet
kouita	kuita
adrestpar	adreistpar
dismeg	dismeg
skridvarnerez	skridvarnerezh
Sklipdour	sklipdour
beursavetei	peursavetei
avostadeu	avostado
sklapat	stlapadsklapad
stoc'h	stoc'h
sailhujeni	sailhujeni
voslagout	lagout
Garc'h	gac'hgarc'h
zizurz	dizurzh
dornikez	dornikez
unaneuzegalite	kalite
hadvevan	adveva
jerbellet	jerbella
divelfeti	diverfeti
gloaner	gloanergwlaner
fidandoumen	fidamdoumen
meskdivesk	mesk
gegeliat	kegeliat
gop	gop
tarhereh	tarzherezh
dizornet	dizornadizornia
fobal	fobal
enkrougeuz	ekroug
peurdiskargan	peurziskarga
piger	pigell
frikerienkranked	frikerkranked
vizietat	biziata
histrogel	istrogell
poullklogor	poullklogor
breton	breton
kennasuilhe	suilhasuilhi
portugalat	portugalat
beglemmet	beglemmet
hirvoan	hirvoan
dansersour	daser
aslenn	azlenn
diorroadur	diorroadur
strobell	strobell
lagoutaj	lagoutaj
blejadeg	blejadeg
bosal	boseal
tenneris	tenneris
feller	feller
letin	letin
kalipign	kalipign
brizilha	brezilhi
voulouzet	voulouzet
ahope	hopalhopahopi
awallvlesaz	gwallvlesa
mardandouen	mardandouen
advevan	adveva
diouilet	diouela
chaous	chaous
keneskob	keneskob
nozveziennou	nozvezhienno
lovrnaj	lovrnaj
morgunhen	morwinizh
rodblenia	rodvleina
groz	gros
Setu	setu
Setuperak	setu
Groun	gronn
strabouill	strabouilh
dehiad	devezhiad
demguzet	damguzhet
Gwardma	gward
Dismantourr	dismantrer
dijen	dijen
fringantiz	fringantiz
chapeltat	chapeledachapeledichapeletat
demholl	damholl
fic'h	fic'h
truhkeit	truekaat
gamichal	kammichal
gouezeleger	gouezeleger
vreoz	freoz
gailhastrenn	kailhastrenn
iouadek	youc'hadegyouadeg
Roen	Roen
stopa	stopastopi
bloukenn	bouklenn
Enembeurro	peurrei
ulac'het	uloc'het
eurgauzeaden	kaozeadenn
IaouBask	YaouBaskYaouFask
divez	diwezh
multrrein	muntreri
haddimei	addimezi
faviet	faviet
begechou	begechenn
torchdaouarn	torchdaouarn
blod	blod
kotonerez	kotonerezh
atahinourz	atahinerez
perc'henni	perc'hennaperc'henni
diilizein	diiliza
KadorVarn	kadorvarn
penitanted	penitant
dizanaoudek	dizanaoudek
Grateit	grataet
dukeul	kel
avelouer	avelouer
Eukaristek	eukaristek
trimar	trimard
penndevez	penndevezh
andellad	andellad
bailhesed	bailhez
lennadeg	lennadeg
rasteldoull	rastelldoull
bourrus	bourrus
stokenn	stokenn
draillennet	drailhenna
krekedal	krankavel
lip	lip
latreilhenn	latreilhenn
dijastres	dichastres
soured	soured
arestennou	arestenno
Satordeienn	satordienn
kanak	kanak
frez	friz
eurhaoliad	gaoliad
trank	trank
lezenndiazez	lezenndiazez
zaeoudu	saezu
treuzvor	treuzvor
Gorjellet	gorjellet
alarc'h	alarc'h
eurc'hrenndouseg	krenndouseg
peurskarza	peurskarzha
difforchus	diforc'hus
begad	begad
broudet	brodet
Flemmet	flemmet
tihargatal	dic'hargatal
marc'hraden	marc'hraden
Negastrouzetket	kastrouzi
antirenntired	antirenn
barrkrenn	barrkrenn
tidenvi	didevidideva
leueg	laoueg
arc'haloch	galoch
degasamzr	degasamzer
Koarenni	koarenni
hirvarc'hata	hirvarc'hata
mammagoz	mammagozh
mekanik	mekanik
kizeinfri	kizakizi
Azindannoz	azindannozazindanannoz
marnaonia	marnaonia
louzouoniez	louzouoniezh
lipad	lipad
Kedik	kedik
lorbus	lorbus
drailheist	drailheiz
politikach	politikaj
Karenn	karenn
dizingalder	dizingalder
dileuet	dileueet
diflat	diflatrdiflat
sankrampoehdal	sakrampouezh
sulriad	solierad
evitdoare	evitdoare
plean	plaen
Flatoullat	flatoullaflatoullat
awirvat	awirvat
diva	divav
giza	kizakizi
dislavariek	dislavariek
chouannaj	chouanaj
sapredien	sapredien
jalgod	jalgod
logellou	logell
spilhaouek	spilhaouek
follzed	follez
arveid	meid
vac'hagn	mac'hagn
bihouilh	bihouilh
pennmvi	pennmezvi
paganat	paganat
japanek	japanek
turmuch	turmuch
klotennet	klotennet
spoeza	spoesa
avouzc'hoarzas	mousc'hoarzhin
trafikerez	trafikerezh
daourealad	daourealad
grosa	gros
Teusknoz	teusknoz
materiet	materia
fanisan	fanisa
eundrogam	trogamm
gouiler	gouestladur
gemerettruezouz	truez
didrubuilh	didrubuilh
plac'hhefenn	plac'hhefenn(heunan)
broched	broched
kenlad	kanellat
diriskl	diriskldirisk
roumaniat	roumaniat
amgarget	amgarget
kistinennvoc'h	kistinennvoc'h
eurgarrikellad	karrigellad
roltet	rolti
magetan	maget
lipet	lipet
dilorc'hus	dilorc'hus
spurji	spurjaspurji
penfollerh	pennfollerezh
dilazet	dilaza
Nazic'hrasieket	dic'hrasia
dirapi	dirapi
vegedog	begedog
drapait	dirapi
kartermestr	kartermestr
rasailh	razailh
parlanter	parlanter
barennoz	barvennnoz
dinec'h	dinec'h
nerzusaat	nerzhusaat
distrap	distrap
Rusian	rusian
frommus	fromus
dizemgleo	dizemglev
figusaat	figusaat
parkul	palkulparkul
kloarekeit	klouarekaat
truillenek	truilhennek
chuerjal	chuerjal
drama	drama
darnet	darnet
treniado	treniad
lufr	lufr
torrimelet	torimellet
Kempennachou	kempennajo
jaret	jaret
Madedoue	madedoue
foenmelchen	foennmelchon
emrenerez	emrenerezh
sellergwizi	sellergwizi
Stagetoh	staget
toket	toget
jeun	jeun
angoulet	ingoulek
krotouz	krotouz
naroudnarabez	rabez
bernwarvern	bernwarvern
ziheurtein	diheurti
baraka	baraka
ion	tudoniour
motet	motet
maenglan	maenglan
boulomNoel	boulomnouel
ergenn	ergan
vrein	brein
Mewijennet	mezvijennet
stouvou	stouv
bernwarvern	bernwarvern
Odena	Odena
c'hlenvedpeultrin	klevedpeultrin
Abalafin	abalafin
grapeptra	grapeptra
araokaat	araokaat
erbriellenn	priellenn
gatkizat	katekizakatekizat
diauzet	diaozet
krabanoek	krabanaouek
chouket	chouket
Vrok	Ereg
baouz	babouzez
Dadra	dadra
zavelli	savellisavella
likoerenn	likouerenn
Anemized	anemiz
Vadam	madam
Stoncan	stonka
Dafaret	dafaret
moumounou	moumoun
saprestor	saprestor
aes	aez
nevezet	nevezet
SanteKroe	Santekroe
Adolpadeu	adolpad(ig)o
goalbedennou	gwallbedenn
Kuikal	kuikal
poudouroum	poudouroum
fbl	febl
nivret	niveret
peuryac'haat	peuryac'haat
eurc'hrenndi	krenndi
digorerml	digoarermel
dic'hloar	dic'hloar
mangnous	magnous
kenikornek	kanikornek
aslenn	azlenn
kroaziou	kroaz
arc'hatalaneg	katalaneg
alac'hkiklanv	alazhki(klav)
touerien	touer
dijastreoc'h	dichastre
kroglinennann	kroglinenna
fraouilleg	fraouilheg
arc'houere	arc'houere
Abennkont	abennkont
avnfians	avenefias
Chebou	chebou
Fiskal	fiskal
baoutet	beudet
azokontrolfetd'	kontrolfed
peurzisfelebet	peurzihevelebi
Distoladeno	distaoladenn
eundrugar	trugar
kammedokarr	kammedkarr
dinobl	dinobl
hadtommet	adtommet
nevez	nevez
Regennet	regennet
rugrin	grin
strambouilhaj	strambouilhaj
digoret	digoret
didamman	didammadidammi
parlak	parlak
choulaz	choulaz
Gastedie	gastedie
rabilhat	rabilhat
saouzanenn	saouzanenn
griz	gris
baokrog	pavkrog
rebard'	rebarda
frikreien	frikreien
dilabe	dilabez
tazenn	tazenn
filma	filma
Nandekvet	naontekvet
kenliorzou	kenliorzh
pennsailhet	peseliet
arblour	paelour
busellat	bustal
leineureud	leineured
serrantuz	serrantus
Teologiezh	teologiezh
Kakac'hig	kakac'hig
alammat	alammat
aberze	perza
liouskriva	livskriva
drailh	drailh
matier	matier
diskouezerien	diskouezer
ahadrento	adrenta
Palamastrenna	palamastrenna
kifet	kifet
arGumun	kumun
objektivel	objektivel
echuadenn	echuadenn
adroc'htranch	troc'htrach
dinoazuz	dinoazus
lardpig	lartpik
choulas	choulas
brumachennek	brumachennek
liammet	liammet
Alfet	alfet
tor	tor
diskoulmet	diskoulmet
glazik	glazik
gallegpodou	galleg
strobellat	strobellat
lodennvarr	lodennvarr
dienkrezi	dienkrezi
dilennidi	dilennad
dispount	dispont
adunanas	adunani
distrantet	distrantet
trekou	trekoutrekoui
Distreuzi	distreuzi
pich	pich
Guzn	gwevn
badou	bado
taolenni	taolenni
adonigenne	tonigenni
dre'nhentse	hent
ovilzina	milzina
okafe	kafeenn
andona	andona
bevech	bewechbewezh
nerzhetoc'h	nerzhet
dilanchen	dilachenn
rollad	rollad
latouza	latouza
kistinv	kistinfaou
skop	skob
yen	gwenter
Alfaudiz	alfaodiz
dibae	dibae
divorfil	divorfil
Japan	Japan
ranell	ranell
Teadekaat	teodekaat
diavz	diavaez
femelenn	femelenn
dougerienfrouez	dougerfrouezh
Damouela	damouela
ed	bak
flatoulla	flatoullaflatoullat
skuiz	skuizh
beon	beon
Lostigat	lostigat
spagnol	spagnol
gwelabl	gwelapl
diboell	diboell
pinijennus	pinijennus
arboblad	poblad
vouedglaz	bouedglas
erez	erez
disvarn	disvarn
dilaoienn	dilavenndilavienn
Garved	garved
Loeiza	Loeiza
Charn	charn
ahadtreuzas	adtreuzi
louedenn	louedenn
aremermour	aremour
dijen	dijen
arwezenndann	gweztann
satorgoa	satorgoae
dispontein	dispontidisponta
Tunizi	Tunizi
krennvrezonek	krennvrezhonek
GorreKerne	GorreKernev
vahtillata	bazhdilhata
ahatio	hatial
Adauleu	adaolo
Pout	pout
tonebrel	tonn
adreujou	adreuzjouadreuzo
otroumobil	aotroumobil
relijiel	relijiel
Tubazenn	tubazenn
argleuzenndrev	kleuzenndrev
dudiuz	dudius
ed	dremedal
koza	kozhakozhi
aveskell	aveskell
Muianiver	muianiver
D'abardaeznoz	abardaeznoz
lammsailh	sailh
skarmote	skarmotal
abrezherr	abrezherr
sperlet	sperlet
melved	melc'hwed
bonedigtouseg	bonedtouseg
glizhaj	glizhaj
erienenn	erienenn
diskoeadeg	diskouezadeg
goularzus	goularzus
politikel	politikel
binichet	binichet
awalc'hkalon	awalc'hkalon
eurgampan	kempenn
erhuhlor	kuzhloar
grimeu	grim
neudet	neudet
azindanenvor	azindanevor
dizurzou	dizurzh
kwita	kuita
varentenn	wareeuntenn
chikolokenn	chigolokenn
tarzdeiz	tarzhdeiz
Trobidell	trabidell
uropean	european
skandinaviat	skandinavatskandinaviat
chinz	chinez
lip	lip
pourprachou	pourpezpourpaj
Ha	ha
saillet	sailhet
mucha	muchamuchi
lezober	lezober
delivrans	dilivras
arbeulvaned	peulvan
diboentet	diboentet
zidozat	didoazat
Gwalic'hed	gwalic'hed
taked	taked
digredenn	digredenn
terruplaad	terruplaat
gris	gris
abar	abare
Flutet	flutet
glazur	glazur
Ampusturi	ampusturi
terez	terez
dirounna	dironnadirounna
poukein	pouki
ac'hlasveze	glasvezi
hanvaladen	havaladenn
dislotetezaoulagadgata	dilontretdislontret
drelaer	laer
tudet	tudet
sourbedein	soulbedi
Ijinour	ijinour
didammein	didammadidammi
ava	va
lostleue	lostleue
Combodcombodou	kombod
sutellat	sutellasutellat
ayoulDoue	ayoulDoue
trapeptra	trapeptra
dourmelen	dourmelen
treuzeurel	treuzeurel
arc'hranchadennou	krachadenn
divoull	divoull
futet	futet
menon	menon
horos	horosi
anvz	avaez
Milmarc'hastandiaoul	marc'hast
dibriet	dibriet
n'ekwir	nekwir
freuza	freuzafreuziatfreuzi
gouihue	gouez
Kallagiz	Kallagiz
digeltiek	digeltiek
sec'het	sec'het
digoret	digoret
houstet	houstet
indezeuropek	indezeuropek
kran	krantez
aterseu	aters
eurbegad	begad
rabasdirabas	dirabas
dismeg	dismeg
barbared	barbar
Maloaned	malaouan
loufog	loufeg
savenn	savenn
kludet	kludet
rasket	rasket
kapuchonned	kapuchon
stard	stard
hoedateit	koadata
skora	skora
savadenn	savadenn
abuzi	abuziabuz
truflennuz	truflennus
Alvaonet	alvaonet
gronchet	grojet
denez	denez
logel	logell
Diseurt	diseurt
trufla	trufla
henvrezhonek	henvrezhonek
sloveneg	sloveneg
ganuzet	ganuzet
chistrbihan	sistrbihan
gwardkoad	gwardkoad
lichefread	lichefread
hivizenn	hivizenn
turiadennou	turiadenn
hirgarrezek	hirgarrezek
lijar	lijer
arzodet	arsodi
nedintasger	tintaltinta
chenjennein	chejenni
uz	uz
tromplzon	tromplezon
broc'hadeg	broc'hadeg
klodi	klodaklodi
Distrouilh	distrouilh
joal	joal
planedennet	planedennet
kelenglas	kelennglas
Skoutelez	skoutelezh
dihanlabour	dihanlabour
digourzein	digoulzi
dizenoe	dizenoe
goursao	goursavheol
dintina	tintina
vanbochereh	bambocherezh
bill	bilh
ribina	ribina
transuillet	trasuilhet
disranner	disranner
agueu	gaoui
brinsez	prisez
keuneudek	keuneudek
chistro	chistro
difer	difer
argenyezoniez	kenyezhoniezh
MoulizEnez	MoulizEnez
Hei	hei
falobr	fallober
azederae	sederaat
laronvor	laermor
houarnezet	houarnezet
botourkoed	botourkoad
kaktus	kaktuz
olvadeleh	hollvadelezh
arc'hefiouespern	kefespern
azeuldi	azeuldi
romanek	romanek
blch	blech
fancqegueryen	fankeger
Seul	seul
behinbos	bos
gwrac'hienn	gwrac'henn
digorezivesker	digor
ildrec'h	ilgrec'hildrec'h
prigaz	prigas
limonad	limonat
tirodan	diroda
gwenojen	gwenodenn
Yeodediz	Yeodediz
lestrsplujer	lestrsplujer
diavezidi	diavaeziad
kofellek	kofellek
dibeilh	dibeilh
Blinch	blech
ofikle	ofikle
bre	susombri
ziarbend'	azirbenn
bezhinskign	bezhinskign
alouberien	alouber
finfondet	finfonta
sklavakoun	sklavakon
breton	breton
foncher	fosier
malac'htu	mallac'htu
mastoufet	mastoufet
Divoser	divoser
Spouronet	spouronet
diroudenni	diroudenni
marc'hmenez	marc'hmenez
o	bomm
ablas	ablas
Distoladennou	distaoladenn
tuforet	touforet
edekenned	tekenn
abuzi	abuziabuz
stragnad	streiniad
Binderidinbinbaon	binderindinbinbaon
kultuel	kultuel
digompez	digompez
mehollka	holleika
ydennou	edenn
difranet	difranet
provanseg	provaseg
tuilh	tuilh
arc'haloj	galoch
prada	prada
vennant	mennentez
bagerien	bageer
anavout	anavezoutanavoutanaout
lrennotal	lrenndal
zibluskenni	dibluskennadibluskenni
Ergan	ergan
velkenthagoude	evelkentevelkent
tompi	toumpi
poherh	poazherezh
gatrat	katerat
arvouchedenn	mouchedenn
grammadeger	gramadeger
gotek	gotek
eskobiaez	eskobiezh
loget	loeget
farbota	farbota
roufennet	roufennet
tachour	tachouer
manioc	maniok
dreistnatur	dreistnatur
Goafgwaf	goaf
Teuskounoz	teusknoz
divestign	diweskenn
disusuna	disusuna
urvollereheu	moullerezh
klakenni	klakenni
repeisamb	repeisi
skosellek	skosellek
golernet	gwalarni
Kardinalgoard	kardinalgward
prakuliad	prakuliad
scanvaat	skavaat
daougammet	daougammet
skuizh	skuizh
ansans	asas
lizeu	lizev
erc'hiosko	kiosk
anaoudeien	anaoudeg
chapeletat	chapeledachapeledichapeletat
disans	disas
skoazella	skoazella
lopou	lop
Madedoue	madedoue
jestaldeuz	jestral
amzivad	amzivad
bonjouri	bojouri
pelldon	pelldon
peurvouget	peurvouga
zifuilha	difuilha
menon	menon
mik	mik
baldanz	baldas
streinet	streinet
daich	deich
tremeniad	tremeniad
harluet	harluet
Ragaroueziet	ragarouezia
paramptez	paramptez
pechad	pezhiadpezhad
ren	ren
poursi	poursuilh
peurzalla	peurzalla
ranellerez	ranellerezh
enememmel	emelloutemella
Daledarre	daladarre
eurvoruenn	moruenn
digasdazonchdin	degasdegasi
Asavtaol	asavtaol
Ruta	ruta
safari	safari
aisit	isita
diaoulezed	diaoulez
bruderien	bruder
BankTosel	tosel
adeoliet	adeoulia
redadeg	redadeg
zutenn	sutenn
azoubennas	soubenna
forzik	forzhik
Gwennael	Gwennael
kuillein	kuilhakuilhi
ebena	ebena
adaulsompern	adaolsourpren
horoz	horosi
jorgeller	jorgeller
wriziaoui	gwriziaoui
anoazed	anoazhet
diaplik	diaplik
digompez	digompez
ekeithama	ekeit
houarngwevn	gwevn
besier	besier
zivate	divatadivati
flejou	fled
dic'haouet	dic'haouet
diskuizhadusted	diskuizhadusted
eglapad	klapad
goallhano	gwallanv
paneogwir	paneogwir
vleukata	bleukata
Fed'amdero	derv
Divenn	divenn
FacharBorn	Fach
damvouget	damvouget
Goulonkusoc'h	gourlonkus
digantaj	digantaj
gourlaret	gourlavaroutgourlavaret
arvilinaskorn	milinaskorn
ravoderez	ravoderezh
zigrasa	digrasa
adaulsompren	adaolsourpren
gwarezad	gwarezad
hetat	hetaatheti
greunwin	greunwin
fenestr	fenestr
digledour	digledour
resorchou	resort
Gwioul	Gwioul
dudiuz	dudius
avarc'hmenez	marc'hmenez
falc'heg	falc'heg
aziskordas	diskorda
Farbotet	farbota
tres	tres
fourradou	fourrad
z'	z'
chingailha	chingailha
divent	divent
rasklet	rasklet
Mac'h	mac'h
ed	amiod
disvoued	disvoued
krennbenneg	krennbenneg
oberallorigganta	lorig
seblant	seblant
diboell	diboell
vajanek	bajanek
naercobra	naergobra
triouec'het	triwec'het
disranna	disrannadisrann
bikel	kel
kouskr	kouskr
firitellou	firitell
ou	palouer
meneztan	meneztan
pastellek	pastellek
muzcomset	mouskomz
adbonna	advonna
rodvleinerez	bleinerez
skarzergodellou	skarzhergodello
gouez	gouez
vrikio	brikiobriko
agantou	aganto
agorfroched	agorfroched
troiobrec'h	trovrec'h
lammpenndibenn	lammpenndibenn
veankorn	maenkorn
c'houezekkant	c'hwezekkant
lufr	lufr
limouzenn	limouzenn
Dirabansi	dirabasi
lammsailh	sailh
gros	gros
agorfroched	agorfroched
mallouztouen	mallozhtouenn
dihoarh	dic'hoarzh
treuzcomzed	treuzkomz
BroWereg	BroWereg
gwallaz	gwallaz
druillo	truilha
enhouantaenneu	c'hoantaenn
skosellek	skosellek
avoultrer	avoultreravoultrier
diharak	diharak
siroz	siros
azistrisa	distrishaat
abepamzer	amzer
asoul	asoul
divraza	divrazadivrazi
dizhrezh	dizerzh
Champalpigellat	champalpigellat
adidrille	didrilha
digoumoulet	digoumouladigoumouli
diskouezadego	diskouezadeg
gansaj	gasaj
karnet	karnet
chigarda	chigardachigardi
Eflam	Eflamm
abokez	abokez
taolru	ru
krabonet	krabanet
enhoc'houlz	koulz
bria	briabrii
soutilite	soutilite
disklorennet	disklorenna
Satordallik	satordallik
c'harakter	karakter
estergann	sterganni
Korftro	korftro
libistret	libistret
diskeud	diskeud
diochet	diaochadiaoch
o	sabot
diharza	dic'harzha
arC'horan	koran
chourgan	sourgan
fleuramann	fleuramanenn
zaoubenni	daoubenni
gaouyerez	gaouierezh
Doustadik	doustadik
hundi	hundi
dinaturan	dinaturadinaturi
nevez	nevez
makoazaz	koazhakoazhi
loc'het	loc'het
votzat	botezat
kendijeinhatra	dijen
aziribignouto	aziribin
vrokusted	brokusted
dudia	dudia
hadlansan	adlasa
tourgov	tourgof
friolor	frilovr
floskr	flosker
aantonas	antoni
chapeledad	chapeledad
Diankennet	diankeniadiankenat
katekiza	katekizakatekizat
lazdi	lazhdi
dic'hlosa	dic'hlosa
arvazrousin	bazhrousin
estartaont	startaat
adtana	adtana
dihaill	dic'hailh
Arvouzarente	bouzarentez
bolsyougoarec	bolzwareg
steredenna	steredennisteredenna
tudet	tudet
didaill	didailh
souchadenn	souchadenn
ormela	ourmela
penveudet	pennvaoutet
marc'hkezeg	marc'hkezeg
arc'housklein	kousklein
trespas	treuzpas
skanvat	skavaat
aljerian	aljerian
seulvui	seul
gleukez	gleukez
jandarmed	jandarm
zigrota	digrota
afferus	eferus
diaveziadez	diavaeziadez
grouidigez	krouidigezh
mestrtaol	mestrtaol
Abostoler	abostoler
bon	bon
Pouellgor	poellgor
ludueg	ludueg
lennadeg	lennadeg
labourerporz	labourerporzh
krapos	krapoz
peuzdiez	peuzdiaes
sabaturus	sabaturus
adizhhagadag	adizhhagadag
TieTie	tie
hlet	haelat
crouadenneu	krouadenn
seblantt	seblant
Nondondistag	nondondistag
rl	arall
santelaat	santelaat
vezineta	bezhineta
diaozet	diaozet
tisvoueda	disvouedadisvouedi
tresul	tresutresul
marka	marka
dismellat	dismellat
etigilhas	digilha
Memoret	memoret
nerzkalon	nerzhkalon
kaer	aguzhkaer
oget	oget
zilosta	dilostadilosti
japoneg	japoneg
skosellek	skosellek
Bisig	bisig
dizuardein	dizuardi
abuzi	abuziabuz
Dioch	diaochadiaoch
sunerien	suner
boufam	boufam
tidisklao	tidisglav
bidanell	bidanell
braselldivrasell	braselldivrasell
bourusat	bourrusaat
dismeganset	dismegaset
Pistolodi	pistolodi
boudoudouf	boudoudouf
aveloular	avellaer
dalkein	talkein
Fleurennet	fleurennet
morailhou	morailh
gwelabl	gwelapl
tuta	tuta
tiliantiz	diliantiz
priprat	priprad
meurvad	moarvat
dinec'h	dinec'h
bead	bead
c'hwikhac'hwek	c'hwikhac'hwek
eunan	eunan
mailh	mailh
displuet	displuvet
Dobi	Tobi
flipaterez	flipataerezh
gouloured	goulored
zivrehonekat	divrezhonekaat
tlpesked	taolpesked
douladein	toulladi
ganas	gas
imurein	imori
difuilhet	difuilhet
dan	deuv
poursuilh	poursuilh
alsion	alsion
beurdistagan	peurzistaga
divalvennet	divalvennet
begad	begad
belosttoniet	belosttoniet
vodka	vodka
garnij	karrnij
Bijolrou	bijolro
HouHou	hou
bireu	bir
ragaoza	ragaoza
voderanz	moderas
kouignpatatez	kouignpatatez
prenvedgwen	prevgwenn
danjr	dajer
lestrtorpiller	torpilher
liorzad	liorzhad
Jaalians	javalias
Anveaou	anveo
dirlink	dirlink
boufam	boufam
stoufell	stouvell
digouef	digoef
azivod	azivot
bommc'hoarz	bommc'hoarzh
fonaploh	fonnapl
demvelen	damvelen
lerc'heria	lerc'heria
abephent	hent
ranngaloun	ranngalon
diboell	diboell
c'houezdourdispenn	dispenn
daoubenni	daoubenni
urgrampinell	krapinell
meskget	emesk
trist	trist
praj	peuraj
tivet	tevet
cadorgib	kadorgib
dilhoulen	dihoulenn
spier	spierspiour
didoket	didoget
fenestrad	fenestrat
keindraeneg	keindraeneg
Cavailh	kavailh
chistraereh	sistraerezh
anunan	anunan
dilamprek	dilampreg
diskreden	diskredenn
loskus	loskus
leazlammersanailh	laezhlammersanailh
lentoni	lentoni
mourvonnet	mourvonet
arc'hofplen	koefplaen
eihdiat	eizhteziad
patronaj	patronaj
hebesk	hebesk
veuda	meudameudi
divouch	divouch
chipotourz	chipoterez
Debepkours	koulz
astrollad	astrollad
stoupa	stoupa
solier	asolier
muelbihan	mevelbihan
arc'haniliz	kaniliz
Chef	Chef
giriouardamez	gerardamez
adreuzskoaz	adreuzskoaz
nahennet	nazhennet
toerkorz	toerkorz
ramplus	ramplus
amzerzobet	amzer
ec'hournoserezh	gournosaerezh
batorellet	batorellet
bodoc'ha	bodoc'ha
toniet	toniet
dizale	dizale
sosialisted	sosialist
baltrammryen	batalmer
diriskl	diriskldirisk
Didolpet	didolpi
lougein	loegi
bern	bernmor
kinglav	kinglav
Gwenanenni	gwenanenni
diblusket	diblusket
Daoult	daoult
mahagn	mac'hagn
Mormor	mormor
diglenedein	diglevedi
sumereg	sumereg
emrenerez	emrenerezh
fauzoni	faosoni
krabonnet	krabani
boteller	bouteller
skanvadurez	skavadurezh
gwerliskinad	gwerliskinat
fausoni	faosoni
krafign	krafign
asklabik	stlabigasklabiga
laren	leurenn
dac'houlerc'hat	goulerc'higoulerc'hat
Peurliesa	peurliesa
enemizelaat	izelaat
teziek	tezhiek
hetet	hetaatheti
urgomuniti	komuniti
divohrat	divouzherat
kelou	kelokelav
maezon	maez
goulosket	goulosket
bodennet	bodennet
divrud	divrud
divaradoza	divaradoza
ervrumdoarervremdoar	brumdouar
golieren	kolierenn
dizourna	dizornadizornia
farzgwad	farzgwad
kranksiliou	kranksiliokranksilienn
dudiuz	dudius
tanavenn	tanavenn
genstrivadegou	kenstrivadeg
dioueleda	dioueledi
liorzad	liorzhad
Diroufenna	diroufenna
trederann	trederenn
peguehentamzr	pegeit
diorbid	diorbid
abempenno	pempenn
strabouillaj	strabouilhaj
Charlez	Charlez
anont	anont
Cheffik	Jef
amzrein	amzeri
urgaoleg	kaoleg
enemzivin	divin
damboz	dambaouez
arvammgamill	mammgamilh
sklimpein	sklimpa
vaonetez	baionetez
truajo	truaj
keiniet	keinet
distriz	distrizh
awech	awezh
efion	fioni
Taolia	taolia
Loperek	Lopereg
urstrak	strak
warvetek	warvetek
morchein	morchi
kalegenneu	garegenn
barad	barrad
bareg	barveg
Satordistac'h	satordistac'h
bezin'dun	bezhindon
Diamen	diamen
tremsllan	dremmsellout
chafod	chafod
colltqit	koll
vougasenn	mougasenn
ac'haol	ac'haol
feurafeuria	feurafeuria
Rakkar	rakkar
erviridig	birvidig
bobeu	bob
diskargadur	diskargadur
damdomm	damdomm
spillr	spilher
lavionenn	lavionenn
karot	karot
blank	blank
ezvezant	ezvezant
hadrein	adrei
meneztan	meneztan
manestisiongard'in	manestision
poellek	poellek
prusek	prusek
koantigenn	koantigenn
arc'hourel	kourailh
tadargevier	tadargaouargevier
glaoukoad	glaoukoad
skavennwrac'hwenn	skavgwrac'hgwenn
ambahet	ambazhetambac'het
glavdourbil	dourbil
afuilh	afuilh
hourz	hourz
douarlabour	douarlabour
dic'hodella	dic'hodella
hint	int
biou	biou
debret	debret
aadkane	adkana
les	lies
morgann	morgann
arvida	bida
warzirabaz	dirabas
Ac'haoliad	gaoliad
skoliata	skoliataskolata
vorlarjeza	meurlarjezameurlarjezi
Saperlot	saperlot
songalv	songalv
cher	aocher
andanno	tanav
grinac'het	grinac'het
goursouezet	goursouezhet
foncher	fosier
tramailhat	tramailhattramailhi
taltous	taltouz
firitellou	firitell
frehegi	frouezheg
sourdouilhat	sourdouilhat
ziroda	diroda
diaket	diaket
stoha	stoc'ha
dourdiwan	dourdiwan
Bibig	bibik
torrreor	torrrevr
genaouegi	genaouegigenaouegal
hanterheur	hantereur
eadfreskdidan	adfreska
Ekeitse	ekeitse
lapineta	lapineta
fankigellet	fankigellet
laziokanan	lazkana
Armarc'hadourgwinizd	marc'hadourgwinizhdu
staponet	staponet
porzc'hoari	porzhc'hoari
tibhourein	dibec'houri
foulkilata	poullkilata
Fuet	fuet
kktad	keketat
harlueteuzhevro	harluaharlui
sovajiri	savajiri
skorpul	skorpul
grosill	grosilh
Ermaeziadeg	ermeziadeg
japeledi	chapeledachapeledichapeletat
iskinet	heskinet
tifest	tifest
dougdougdoug	doug
etanryen	entaner
ribla	riblaribli
Petoare	petore
didivadidivi	didevidideva
eurbintadez	pintadez
lagadet	lagadet
titouri	titouri
bikh	beig
sevenet	sevenet
io	pe
hepmuzul	muzul
enebiez	enebiezh
pennoberou	pennober
skeudennek	skeudennek
simijou	simijo
kranksilienn	kranksiliokranksilienn
bernkaoh	bernkaoc'h
hersalhadihersal	hersalhersahersi
pouta	pout
na'vitse	evitse
ahurusunas	hurusuni
sinema	sinema
bangor	bangor
Douranik	Douranig
lavarennodizalc'h	dizalc'h
reveulzet	reveulzet
diougevrennek	divgevrennek
agreiz	agreiz
Kas	maez
Asederre	sederaat
heusen	heusenn
aheurtajahurtaj	aheurtaj
saoz	saoz
stlibig	stlibik
jober	jobar
kegnignet	kigninet
warneunv	warneuv
marc'hlevr	marc'hlevr
hadtreuzi	adtreuzi
Argountellskiz	kontellskizh
direnk	direnk
divoedet	divouedet
dosilaat	dosilaat
Dampasion	dampasion
toullourgouilh	toullourgouilh
abennporc'hell	abennporc'hell
dic'hoarz	dic'hoarzh
tesadenn	tesadenn
brohdon	brozhdan
difalloh	difall
dre	treuzdidreuz
divrezonega	divrezhonega
Drzalh	drezalc'h
baskein	baskein
brein	brein
tieh	tie
gouegelenn	gouegelennenn
demper	temper
Sardoni	sardoni
Hei	hei
ntanet	entanet
portugalek	portugalek
polis	polis
ahntaral	arall
yoerez	yoerez
brudour	bruder
tatagozh	tatakozhtatagozh
amuzettez	amuzetez
kastellurgastell	kastell
touiadelleu	touadell
diwarhanterc'her	hanterc'her
dizale	dizale
flemmet	flemmet
dreserr	dreser
kremilgurun	'kre
peurvrezonekaat	peurvrezhonekaat
daulskri	taolskriva
Eundorpilhen	torpilhenn
fiabl	fiziapl
skruset	skruset
brog	brog
Boc'hus	boc'hus
kludet	kludet
begadeu	begad
naroudnarabez	rabez
skoachig	skoachik
gwezroz	gwezroz
divuset	divusi
nouch	nouch
froudad	froudad
dic'hlaniet	dic'hlanniet
dic'houdor	dic'houdor
terziennec	terzhienneg
aerlestr	aerlestr
kurzet	kurzhet
istrogell	istrogell
gripp	grip
beilhenn	peilhenn
dibried	dibried
gouzel	gouzer
malestout	mallestout
torgennek	torgennek
roj	reud
arvreac'hzu	brec'hzu
vugalenno	bugalenno
ribotadenn	ribotadennribodadenn
ermeazanz	ermaezas
evitdoare	evitdoare
kongnardez	kognardez
flisterezed	flistrerezdour
digoustians	digoustias
grondin	grondin
ampouezouner	ampoezoner
menezieg	menezeg
boultrerez	poultrerezh
perigkofruz	prigkofruz
deuhantereg	daouhantereg
Marzin	Marzhin
Aberet	abeuvret
borledennou	bourledenn
renklen	renklenn
Amkraz	amkraz
tiegezchennou	tiegezhienno
'neminzac'han	ensac'ha
prech	prech
limonengar	limonenngarr
pous	pous
fapertremen	papertremen
difetis	difetis
koedtan	koadtan
vroustaad	broustaat
eurgirinad	kirinad
douardidremp	didremp
chaltapi	chaltapis
vatouilh	batouilh
aaddimezas	addimezi
zaoutenn	saoutenn
adreiza	adreizha
ablen	plaen
genganerezh	kenganerezh
meskaj	meskaj
traversidu	traversido
glaoeyer	glav
behinkurs	kurzh
promessa	promesa
Sapredie	sapredie
lienpillou	lienpilho
ampaourig	ampaourig
goarnasion	gouarnasion
digik	digig
kelvid	kellid
garsalen	garsalenn
rewi	revi
deskad	deskad
begadou	begad
men	man
satordallik	satordallik
straveller	straveller
zoniri	soniri
camdroeu	kammdro
Disparat	disparadisparidisparat
Krankedmordaved	mordavad
gourich	gourriz
baraenneu	baraenn
Treuzioutreujou	treuzo
stankalan	stankanal
distronsusa	distrosus
stamouzet	stamouzet
piano	piano
pouellgor	poellgor
huengam	gwenngamm
lavagnona	lavagnonalavagnoni
louffoc	loufek
sermantet	sermantet
matmatigeu	matematigo
mahet	mac'het
pokezhapokez	pokez
serbat	serbat
harpenharp	harpenharp
Choupa	choupa
ziskellad	diskellat
diglenved	digleved
pempenn	pempenn
euskareg	euskareg
chodet	jodet
skiltrou	skiltr
radenbleiz	radenbleiz
piko	piko
kouskt	kouskaat
pennkenta	pennkenta
erbousen	pousenn
eweladennerion	gweladenner
pourvezaso	pourvezas
enebach	enebaj
GweOliv	gwezoliv
Eunengroezadud	engroez
raperez	raperez
Gwardma	gward
butunalenn	butunalenn
blejadeg	blejadeg
akonit	akonit
kazalet	kazelet
skerb	askerb
tieko	tieko
dreeno	eno
disrannour	disranner
gwiv	gwiv
platin	platin
ehers	hersalhersahersi
komunist	komunist
nigroial	evnigroial
frakent	fraki
voslagout	boslagout
lichuen	lichuenn
diskraniet	diskrognet
kitous	kitous
adarlamme	darlammat
Sourleuin	sourlevenez
ahelpennje	helpennhelpenni
treuzad	treuzad
ahardi	ahardizh
urc'hornigpri	kornpri
eurbarrouziad	parreziad
aoulan	ac'hwilan
morziad	morziad
kembreat	kembreat
Bi	Biel
eurbrosession	prosesion
digelionenn	digelienenni
loarfin	loarfin
kokoz	kokoz
valewarroudou	roud
dorajer	dorajer
Laurenz	Laoras
telefon	telefon
divrezhonekaat	divrezhonekaat
mac'hagn	mac'hagn
listridredan	lestrdredan
reveulzet	reveulzi
blaouer	blaouaer
fondein	fontafonti
crampinellou	krapinell
italianeg	italianeg
farlea	farlea
'nemizelt	izelaat
reierrodell	roc'hrodell
uhelvourzh	uhelvourzh
spegus	spegus
maenridour	maenreder
parea	parea
parlak	parlak
malotru	malotru
argomzenn	komzenn
Ind	Ind
urgantol	kantol
levrierleorier	levrier
eberramzer	amzer
bozniat	bosniat
berboellerez	berrboellerezh
dighadrag	drag
avoabettouchoc'h	touch
Doubledie	doubledie
azic'hlanan	dic'hlana
dislotret	dilontretdislontret
fleur	fleur
lop	lop
taffia	tafia
lip	lip
kordennet	kordennet
garzo	karzo
raksojo	raksoj
YourhennadYourhenni	yourc'hennat
ion	jedoniour
awell	awell
tibank	tibank
kostezkostez	kostezkostez
peurunvan	peurunvan
turlutuaj	turlutuaj
koltar	koltar
adsternet	adsterna
perstoup	perstoup
kizal	kizal
Diaozet	diaozet
Tlpesked	pesk
labourerkr	labourerkr
Drehostigennoc'haet()	stigenn
peuzkerkent	peuzkerkent
denenn	denenn
arvavitenn	bavitenn
bralbrel	brall
c'hlazeri	glazeri
polis	polis
difindaoni	difindaoni
glasreo	glazrev
diset	disaldisi
Laviga	lavigalavigat
Urc'hovard	kovard
ZantKarre	SantKarre
enemskoazellomp	skoazella
eurveudadenn	meudadenn
sekreten	sekretenn
disemur	disimur
pedennoulid	pedennlid
truajou	truaj
ancofua	ankoua
nouilhez	nouilhez
Aven	aveiaven
elvad	elvenn
zabature	sabaturi
wallonek	wallonek
brons	prons
holosennou	olosenn
opiom	opiom
Breinpud	brein
louidigou	louvidig
dilabour	dilabour
valpein	balpi
amboubal	amboubal
marc'hdu	marc'hdu
guiaderz	gwiaderez
noumsq	emesk
dinah	dinac'h
Diveleg	diveleg
populo	populo
sidan	sidan
botuat	potevat
digardellat	digardellat
brammsac'h	brammsac'h
aziwardro	aziwardro
soagnal	sognisognal
kenetrezoc'h	kenetre
norman	norman
avalegi	avaleg
peurgloza	peurgloza
huruss	hurus
hortadenn	gortadenn
Arc'homplidiou	komplidi
sofistiezh	sofistiezh
diakr	diakr
bid	bid
radenbleiz	radenbleiz
Didamma	didammadidammi
gournosa	gournosa
arvalien	arval
divouillen	divouilhenn
giza	kizakizi
chapeltat	chapeledachapeledichapeletat
kasenn	kasenn
pluerc'h	pluerc'h
skoanek	skoaneg
digristenidigezh	digristenidigezh
parfetegez	parfetegezh
kinet	kinet
tredan	tredan
almaneg	alamaneg
diharak	diharak
astrak	strak
Teureug	teureug
merchad	merkad
adstumma	adstumma
askre	askre
asiedad	asiedadasietad
dibrenn	dibrenn
poellek	poellek
Filozofiezh	filozofiezh
enemstropein	stropi
drebiou	drebiou
glizicq	glizig
renevezi	renevezi
sabatetdeha	sabati
treuzi	treuzitreuza
autromeoh	aotromeoc'h
sklearwelet	sklaerwelet
Tez'ta	tez
loenedsamm	loensamm
pezmicher	pezhmicher
bochou	karrbont
fed'amdouken	feizda'mdoukenn
crouidigez	krouidigezh
loraour	loaraer
ZanteKro	Santekroe
eundremenadenn	tremenadenn
Mataragou	matarago
hallohad	galloc'hat
gresetan	greset
fursot	fursot
andon	andon
pareet	pareet
bleun	blu
strapet	strapastrapat
oingnoingn	wegnwegn
louedenn	louedenn
pegoulz	pegoulz
Foutre	foutre
delestaj	delestaj
Kernielandiaoul	kernielandiaoul
eurc'hravazdougenn	kravazhdougen
laouigaj	laouigaj
zours	zours
direunet	direunet
reaz	rez
Pardandien	pardandienn
voulouzennet	voulouzennet
orglzeu	orglez
oc'hroazed	kroazed
piger	pigell
andreven	trevenn
taok	taok
orodet	orodet
Fidadoue	fidadoue
zislemm	dislemm
astroll	astroll
listritaol	lestrtaol
anunan	anunan
o	adjod
sontileit	soutilaet
letrenneu	letrenn
eostguen	eostgwenn
fonabl	fonnapl
Difoup	difoup
amaer	amaer
neoueketechal	chal
skorneg	skorneg
ervarez	marvez
regl	regl
dizouill	disouilh
mout	mout
kinkailh	kinkailh
biwak	bivak
vikank	mekanik
pennfoll	pennfoll
kluka	klouka
danvezlean	danvezlean
oseizhderez	telennseizhderez
bourlleur	boureller
gour	gouere
gwemouar	gwezmouar
arvesterien	arvester
Difurat	difuraat
blean	plaen
mammbardi	mammbardi
velinbrameu	milinbrammo
iverzoneg	iwerzhoneg
kouskr	kouskr
gwezflimmin	gwezflimin
fourgasset	fourgasi
eziborh	diborzhiadiborzha
bekedi	beked
sederaat	sederaat
enemenkrezi	enkrezi
moudennou	moudenn
dileve	dileve
heget	heget
wareboan	poan
makedoneg	makedoneg
scantennet	skantenna
Chistrouenn	chistrouenn
elektrik	elektrik
rodvleinerez	rodvleinerez
sklabezus	stlabezussklabezus
andaolzantel	taolsantel
gabasite	kapasite
rugagn	rugagn
eurc'hrignolad	grignoliad
kovellek	kofellek
lietenno	lietenn
dakor	daskordakor
chik	chik
oberiantiz	oberiantiz
nezigounnareket	digounnari
batar	batar
digredenn	digredenn
fouesder	pouezder
brakogn	brakon
sovetaer	sovetaer
resuour	resever
tredan	tredan
Begoubran	begbran
krohenndigrohenn	kroc'hendigroc'hen
pesketerien	pesketaer
kampou	kampou
Gwinoufer	gwinoufer
Dihillet	dihiliet
kraouia	kraouia
digoustusa	digoustus
dilocha	dilocha
jecherezed	sacherez
Dournerezou	dornerez
huiadein	gwiadi
dihouhinet	dic'houhinet
arhouziadenn	gouzeriadenn
adokad	adogad
melchenprad	melchonprad
pennlavarenno	pennlavarenn
absinth	absint
krabisereh	krabiserezh
afellasgante	fellelfelloutfallout
delc'hanz	dalc'has
geoteged	geotegenn
tennaj	tennaj
kenbaduz	kenbadus
agrsa	krasaat
enemharpa	harpaharpi
dac'hlapezat	klapezat
meuta	meuta
politik	politik
gare	karrez
kostezpenn	kostezpenn
trubuillet	trubuilhet
morgeuz	morgeuz
mandarinez	mandarinez
divot	divot
digarezer	digarezer
truskenn	trouskenn
paotrkezeg	paotrkezeg
falziget	falziget
adruilldrask	adruilhdrask
arC'hermaned	German
zaonen	saonenn
patrour	patererpaterour
hadkemer	adkemer
arc'hentren	kentren
kompez	kompez
azaskiltre	dasskiltra
fouges	fouges
adrespar	adreistpar
tigilha	digilha
edenn	edenn
c'harjata	garzhata
leskelhent	hent
redadek	redadeg
leazmesk	mesk
flegenned	flegenn
speg	speg
marc'hdu	marc'hdu
moulerez	moullerezh
poanizili	poanizili
brouezeion	brouezeg
Milet	milad
stanken	stankenn
togskoev	togskoev
meitour	metaer
Emzidolpein	didolpi
dreidpalankou	palank
Bleuvarsent	bleuvarsent
taranpont	daramponti
avamen	avama
gleuri	gleuri
laka	'ta
kornchap	kornchap
blejadennou	blejadenn
vilbern	milbern
ijip	ijip
c'houez	gouez
rolig	rolig
goasketoc'h	gwasket
veanhigolen	maenhigolenn
sinamom	sinamom
pennfolet	pennfollet
mmon	memev
dregoust	dregoust
Seven	sevenn
digleria	digleria
pimperlammet	pimprlammat
biled	piled
hadgenel	adc'henel
Mona	Mona
larwenan	laergwenan
berwelet	berrwelet
Akre	akre
Broc'h	broc'h
pario	pario
yaoubask	YaouBaskYaouFask
sonerez	sonerez
paravel	paravel
Ulac'h	ulac'h
oldillad	oldilhad
heoliennou	heolienn
telegraf	telegraf
zirollereheu	dirollerezh
dazrec'h	drec'h
gonfituriou	kofitur
agostigellaz	kostigella
berloaj	berloaj
braoentez	braventez
OlaOla	ola
ambludi	ambleudi
Moulloghet	moulleg
ekreizetre	ekreizetreekreiztre
farsellat	farsellat
Pilbodbilbod	pilbod
Milad	milad
kozlammat	kozhlammat
c'h	arvrec'h
zivreiza	divreizha
didalvout	didalvoud
nneu	skladenn
rannyezel	rannyezhel
Feta	fe
fleuj	fleuj
gourjelad	gourletadgourjelad
garven	garven
mormon	mormon
warrauk	warraok
biskouidbeskud	biskuid
divorfil	divorfil
stoubaj	stoubaj
veletenn	beletenn
Plusulian	Plusulian
ilvoud	ilvoud
pesa	pesa
adverc'ha	adverc'ha
maesa	maez
dirol	diroll
dichou	dichou
soredi	soredi
truhkat	truekaat
buanhabuan	buanhabuan
humdorchennet	torchenni
bozamant	pozamant
lostarc'habest	kabestr
dilazh	dilazh
peurzisfelebet	peurzihevelebi
chomeldearvarein	arvari
arc'hoefberr	koefberr
flechek	flechek
ziabaiaein	dibaiani
daziskisa	diskisaldiskisa
mnfondizion	maenfondizion
trehatre	trehatre
Margoden	margodenn
bistolendro	pistolenndro
rahouenn	rac'hoan
glazur	glazur
didret	didaeret
borc'hadenn	bourc'hadenn
okrennwez	krennwezenn
lanchennet	lachennet
maenaoter	maenaoter
liduz	lidus
nejujetket	juji
deliou	deliaouenn
sans	sas
poud	pout
adaulsur	adaolsur
tipita	dipita
mentoniel	mentoniel
naercobra	kobra
wiver	gwiver
Adavik	adavik
wardren	wardrev
moltr	moeltr
divalken	divalkenn
Chargregoj	chargregoj
loras	Laoras
diamodet	diamoedet
tauset	taosi
peurlaza	peurlazha
gwidal	gwidal
teosat	teosat
bintet	bintet
faeziad	faezhiad
bebeilpennereh	pebeilpennerezh
skeuzeller	skeuzeller
parlampi	parlampi
kaoutchouc	kaoutchoug
epractal	raktal
manac'hbaleer	manac'hbaleer
teurkaj	teurkaj
fluimdour	fluimdour
boureryen	boureller
gwardkael	gwardkael
aliou	ali
eimuras	imori
demlous	damlous
baad	pavad
arc'hatekiza	katekizakatekizat
brohendan	brozhdan
Mota	mota
reddired	dired
charpebr	charpebr
Wardre	wardrev
ergvredihul	gevreduhel
assss	poan
turcho	turchenn
segali	segali
galleg	galleg
erion	digarezer
kalonet	kalonet
arvazelar	bazhelar
fourmajlz	formajlaezh
fardaj	fardaj
abegeit	pegeit
broadel	broadel
effijou	efed
eneel	eneel
pichos	pichos
phadeu	pezhiadpezhad
flip	flip
frankusoc'h	frankus
selebret	selebred
Stamouzet	stamouzet
Horpet	horpet
treboul	treboul
aset	asiedasiet
truachou	truaj
digredenn	digredenn
evedistrapdeuz	distrap
klank	klak
braobras	bravbras
gotek	gotek
kagnous	kagnous
aunvan	aunvan
munusenn	munusenn
meudi	meudameudi
ino	eno
boulc'henn	boulc'henn
dibafet	dibafet
Rcgueu	reg
herda	er
markaou	markaou
trasizonet	trasizonet
fok	fok
depechi	depechi
frusket	frusket
sakrilaj	sakrilaj
arangounenne	ronkonenna
disvala	disvaladisvalat
trantelleion	trantelleg
morjin	morjin
tramailhat	tramailhattramailhi
Adammdadamm	adammdadamm
liant	liant
zisloagal	disloagal
melenet	melenet
pegouls	pegoulz
jaujapl	hejaojapl
akipaj	akipaj
avoutrerez	avoultrerezavoultrierez
reputet	reputet
brizamzeri	brizhamzeri
pseer	peseer
perterissein	perterisi
dispak	dispak
degaschonjdehon	degasdegasi
noz	hopernoz
enhentse	hent
atravet	atravet
kenetrezo	kenetre
dieubi	dieubi
pangor	bangor
fromus	fromus
esourgar	soulgaroutsoulgari
peurskrivet	peurskriva
efranchisas	frachiza
stlibik	stlibik
digristen	digristen
touflezi	touflezatouflezi
didoan	dizoan
abeadra	abeadra
flamankeg	flamankeg
gravia	gravia
mistrilabour	mestrlabour
rost	rost
kalvichadur	kalveziadur
gorre	gorre
touezhatouez	touezhatouez
chipot	chipot
lesa	laesha
pevarlammat	pevarlammatpevarlammi
articlou	artikl
androell	troell
lammpenn	lammpenn
Ave	ave
Eskeudze	eskeud
lorbour	lorber
pontguintel	gwintell
melc'houedklorek	melc'hwedklorek
latreilhen	latreilhenn
andrapet	draped
kildrenn	kildroenn
manac'hgwenn	manac'hgwenn
gouez	gouez
toullkleu	toullkleuz
trankilig	trankil
skorz	skorz
brezeliaded	brezeliad
dembarrek	damvarrek
buzugenei	buzhugennabuzhugennatbuzhugenni
arwec'henvouar	gwezmouar
disvoued	disvoued
zreidpalankou	palank
digolliera	digoliera
abenino	abenneno
gwerimier	gwaremm
lousten	loustenn
brisanzav	brizhanzav
rebech	rebechrebechirebechat
dizouea	dizouea
arsilet	arsilet
distaget	arwezet
dilorc'h	dilorc'h
obergloch	gloch
eilkosa	eilkosha
talerloa	talarloatararloa
arvarrendroc'herez	barrenndroc'herez
armel	armelsakr
parka	parka
sarodenn	sorodenn
toc'hota	toc'hata
Enemaddoug	addougen
startaat	startaat
auter	aoter
baradozuz	baradozus
rakkristen	rakkristen
droienna	troienna
tommderenn	tommderenn
tekenned	tekenn
dizro	dizro
anneuzgreatreveulzi	reveulzi
dadouez	dadouez
ziyalc'ha	diyalc'ha
Vitkeloze	kelokelav
eman	brete
bchourkoed	bucherkad
Digoust	digoust
Andouribell	touribell
stranet	stranet
tortennek	tortennek
kwita	kuita
labourspered	labourspered
mik	mik
boulom	boulom
trota	troet
bgad	begad
flac'houflac'hiou	flac'h
laouek	laoueg
espurmant	spurmanti
zorc'henna	sorc'hennasorc'henni
eskeud	eskeud
skeduz	skedus
Bali	Jakez
afuill	afuilh
divatan	divatadivati
aerlestri	aerlestr
antugonit	tugounit
achoupo	choupa
Pilhardach	pilhardaj
plastryen	plastrer
araokaat	araokaat
Chikolodenn	chikolodenn
gouchet	kouchet
n'ouspegehid	nouspegeit
klouaret	klouaret
lezwreg	lezwreg
blansonet	plasonet
Feur	efeur
fleuranhav	fleuranhav
silienn	silienn
discoultrryen	diskoultrer
idgwenn	edgwenn
ebeulez	ebeulez
digor	digor
trouc'hdour	troc'hdour
Daoustouet	daoustouet
avaleudoarklorek	klorek
bugelDoue	bugelDoue
tieuret	tieured
dienkres	dienkrez
menetanek	meneztanek
diyac'h	diyac'h
Palatrez	palatrez
berberek	berberek
taoleugunn	taolgwenan
pln	plaen
jedet	chedet
goalstad	gwallstad
lorvez	lorwez
digelenn	digelenn
danek	danek
hec'harterenna	karterenna
kofilis	kofilis
Begedog	begedog
enhagen	eeunhageeun
disorb	disorb
gourdrouzou	gourdrouz
klenk	klenk
isdouarel	isdouarel
kernevad	kernevat
lijennet	lizennet
diboell	diboell
Bra	bra
pochetneat	pochet
akolit	akolit
grotilh	grotilh
rebech	rebech
Drfin	drefin
fursodet	fursodet
arbeilhaskenn	peilhastenn
saekouronka	saegouronka
keitetd'it	keitet
germaneg	germaneg
morian	morian
chelpel	chelpel
arc'hloc'hgalv	kloc'hgalv
falzkredennou	falskredenn
dilabanet	dilabani
mousklemm	mousklemm
astoc'henn	astoc'henn
charr	charre
varhedkalz	warhedkalz
dic'henou	dic'heno
gouiaad	goavad
butunkarot	butunkarot
sinema	sinema
divrezonekaet	divrezhonekaet
hanhagouian	havhagoav
peurguzumi	peurguzumi
krenn	krenn
glaoudourbill	dourbilh
egodin	godin
touellus	touellus
zibardaone	dibardaona
divreizad	divreizhat
penijennerion	pinijenner
kavzeverrans	diverras
brunellour	bruneller
poultrerez	poultrerezh
arC'henviad	kenviad
abenfinandro	abennfinandro
faroaed	faroaat
obereundommadennda	tommadenn
dreujou	treuzo
amboubal	amboubal
diamennan	diamen
simantenn	simantenn
baramanchi	paramanti
Boulhuig	boulc'huig
diwouez	diouez
sardinerion	sardinaer
bochbinieu	pochbinio
italiekaat	italiekaat
klenk	klenk
Leorbres	levrbres
goular	goular
lerbaj	lerbajlerbiaj
oarm	gwaremm
otialvaoni	dialvaoni
eurc'hroghouarn	kroghouarn
uhelpentet	uhelpentet
arenket	arenket
kelennerezh	kelennerezh
kemerdies	diaez
buuchein	muchamuchi
kroazellet	kroazellet
didrechonein	didrechoni
obrour	oberour
galouperez	galouperezh
Liantoh	liant
tuahoni	doazhoni
Ekonomiez	ekonomiezh
feurdvi	peurdevi
boulommig	boulom
agafourch	kafourch
dizikour	disikour
skourj	skourj
paperacher	paperacher
bremaik	bremaik
legumacherien	legumajer
Adskrivadur	adskrivadur
danzeet	danzeet
dibaianein	dibaiani
eurgenstrivadeg	kenstrivadeg
priza	priza
koufa	koufa
fawen	faouenn
ed	bog
rousinek	rousinek
saillereh	sailherezh
digreden	digredenn
lichet	lichet
chucher	chucher
divinadl	divinadell
Blech	blech
Frasa	Frasa
wenojeno	gwenodenn
kistenn	kistin
oberandrap	drap
chansuschanchus	chasus
azibouez	dibouez
dibesket	dibesket
Bet	bet
nouch	nouch
malloztouen	mallozhtouenn
pellgelaouer	pellgelaouer
dinamit	dinamit
jourdoul	jourdouli
Diskloumma	diskoulmadiskoulm
tivrezouneka	divrezhonega
Troveni	troveni
gouezpeupli	gwezpupli
dic'hoantet	dic'hoantet
dirol	diroll
dilabour	dilabour
dislotret	dilontretdislontret
Akul	akul
brail	brall
dournerez	dornerez
Begmagn	begmagn
madelezus	madelezhus
entaner	entaner
raf	raf
amizion	ami
fiesdo	fiezdoged
tarchou	tarch
Sklasein	sklasasklasi
Kalanheriz	Kalaneliz
Korfennstamm	korfennstamm
enemziyena	dic'henna
tonigenni	tonigenni
disans	disas
zl	sil
Parej	parej
baleadenni	baleadenni
abot	abot
m	er
lezvreg	lezwreg
obrlonseu	loso
plataj	plataj
korbonin	korboni
Amanlenn	amalenn
ridourbro	rederbro
anglz	anglez
diforc'h	diforc'hidiforc'hadiforc'h
zriva	driva
Adl	adaol
humchiffein	chifachifalchifi
beon	beon
blagui	blagi
Grekenn	grekenn
dizec'het	disec'het
kouskidik	kouskidik
ivantori	invantoriivantoria
bourk	bourk
emroet	rei
falskredenn	falskredenn
merdouz	merdous
penndraouigelli	penndraouigelli
dichasour	dichasour
patr	pater
sabran	sabran
digaozeal	digaozeal
harpa	harpaharpi
aadhueh	aadwezh
zikulez	dikulez
korvigellet	korvigellet
reizhskrivadur	reizhskrivadur
digig	digig
kayeret	kaieret
distoket	distokadistoki
dourvnrer	dourvenerel
otarzodi	darsodi
umizlat	izelaat
eurvrochenn	brochenn
Aljemant	alejamant
paramptez	paramptez
enemskora	skora
noterien	noter
toulladet	toulladi
louzousko	louzosko
loarenn	loerenn
gouez	gouez
treboulek	treboulek
bos	bos
chatalet	chatalet
lidel	lidel
skliennek	skilfennek
tennerplanedenno	tennerplanedenno
eaz	aez
didach	didach
primhaprim	primhaprim
lip	lip
ervilaren	gwilerenn
goafbann	goafbann
reut	reud
enebas	enebas
scarh	skarzh
agorfroched	agorfroched
dichak	dichak
aljeriat	aljeriat
Aristel	aristell
bannou	kroaz
uz	uz
eurweendilh	gweztilh
ekreizetre	ekreizetreekreiztre
divomein	divoemi
deliaenn	deliaouenn
dizourec	dizourek
rannvedel	rannvedel
diswenna	disgwenna
skeudik	skeudik
sklasa	sklasasklasi
credounyez	kredoniezh
Riskdouar	riskldouar
let	let
oremusat	oremuzioremuzat
truhgaj	truegaj
sailhoupik	sailhpik
melanet	melenet
blazandev	blaz
fidandoulle	fidamdoulle
meanbarlen	maenbarlenn
warrentenn	wareeuntenn
eurvarled	barled
peurachu	peurechu
Ac'hizall	ac'hizall
penndommet	penndommet
prosezi	proseziprosezal
leanezedkonvers	kovers
Setuaman	setu
draster	draster
argumun	kumun
pobladeu	poblad
lerbiachou	lerbajlerbiaj
mestrkeginer	mestrkeginer
flastruz	flastrus
flat	flat
binieuereh	biniaouerezh
hebmuzul	muzul
divadez	divadez
aflatoulle	flatoullaflatoullat
rimadella	rimadella
kafourchet	kafourchet
tufek	tufektufevek
hunvreer	hunvreer
Kac'her	kac'her
morilhoned	morilhon
aziwardro	aziwardro
machalbotas	chalbotat
anunanpenn	anunan
poelladennou	poelladenn
grampohenneu	krampouezhenn
chasplouzchasplouzed	chasplouzenn
badaouuz	badaouus
guenili	gwennel
bojaig	bojaig
gallouaj	galouaj
DourDi	Dourdi
ekuit	ekuit
edok	edek
koant	koant
guided	gwivded
honnivren	niverenn
lusdenlusuen	louezaenn
bigorned	bigornenn
pelerinan	pelerina
vell	mellamelli
drener	drener
leunc'hoad	leunwad
dargreizet	dargreizet
mazaouet	mazaouet
lostenn	lostenn
eisvet	eizhved
tic'harza	dic'harzha
Katar	katerat
gourlerc'her	goulerc'her
lave	lave
stoliadenn	stoilhadenn
mio	miao
c'horzdour	korzdour
luzed	luzed
distlipa	disklipa
eu	prest
agornadeu	agornado
baza	baza
krec'hiek	krec'hiek
c'houezdourdispen	dispenn
maezoc'h	maez
Seza	Seza
maberiar	mabaryar
batulrieit	batuleri
Teotegez	teotegez
didok	didog
gafeta	kafeta
bosad	bosad
grtarfurch	furch
arc'horndouar	korndouar
craouia	kraouia
jaojabl	jaojapl
dibennadeg	dibennadeg
kraonmouch	mouch
devhat	diwezhad
pil	pil
sourik	sourik
c'haloj	galoch
dibuilh	dibuilh
marc'hloar	marc'hloar
Kastiz	kastiz
bilostou	belost
karrdredan	karrdredan
Kambret	kambret
porchout	porchout
waredrankilite	trankilite
Emellaff	emelloutemella
kilbleg	kilbleg
trea	trea
urhardel	kardell
tenzorer	tezoriertezorer
mengrij	maengris
Ermeziad	ermaeziad
flistrerezh	flistrerezh
avilvern	avilvern
eurbegad	begad
huibet	c'hwibet
hlazvezi	glasvezi
tennaskell	tennaskell
zoudenamant	soudenamant
charitell	charitell
turelhskarh	skarzh
pitaudz	pitaodez
astellereh	astellerezh
dirabas	dirabas
didrast	didrast
sankrampoehdal	sakrampouezh
kasti	kastiz
vadam	madam
avouezenn	havouezenn
divaladed	divalavded
peurdrec'het	peurdrec'hi
rigolennein	rigolenni
Diarvarein	diarvari
bamus	bamus
skraberlaou	skraberlaou
aeradennet	aeradennet
kompez	kompez
brechi	prechaprechi
toutek	toutek
Jozef	Jozef
traoueziou	traouezio
brunellereh	brunellerezh
tregorn	trogorntrogorn
erwinienngrap	gwinienngrap
foug	foug
druilla	truilha
Portugaliz	Portugaliz
liant	liant
zivroidi	divroaddivroiad
enbroidi	enbroad
divlassoc'h	divlaz
diezomm	diezhomm
breanek	breanek
FanchKouer	Fach
garvaet	garvaet
andudaboan	poan
Sklisaouet	sklisaoui
emgastiza	emgastiza
fondet	fontafonti
didrastet	dizrastet
razet	razhet
Bazengibazenga	bazegabazegi
waloberou	gwallober
diframm	diframm
gentriz	gwentrik
hadrei	adrei
diglotenn	diglotenn
eurc'hazerniad	kazarnadkazarniad
rizennou	rizenn
Ardanti	ardanti
erhouill	kouilh
Choc'h	choc'h
boagn	poagn
c'hlasteri	glasteri
bigi	bag
Turlututu	turlututu
tagnouz	tagnouz
aroudennet	arroudennet
gwidal	gwidal
enn	kreienenn
galos	galos
hesqennryenabenn	heskenner
letounet	letonet
Krankgwiv	krankgwiv
breiour	braeer
gornial	kornial
Salan	Salaun
maskou	masko
melc'houad	melc'hwed
arnod	arnod
begvil	begvil
Arpeurliesa	peurliesa
eziskrapell	diskrapellatdiskrabellat
emdrei	emdrei
kammed	kammed
jipotal	chipotalchipotat
bommnoz	bommnoz
biblek	biblek
sportek	sportek
arc'horoadenn	goroadenn
dabourantein	nemoranti
laournaj	lovrnaj
diskeud	diskeud
amwelout	amwelout
skoraegomzou	skora
komunist	komunist
abeurgrenva	peurgrevaat
diroufenna	diroufenna
Trivac'hved	triwec'hvet
stourmad	stourmad
Diamodereh	diamoederezh
astommed	astommet
mintouelle	mintouelle
arc'hrogyoud	krogyod
urvindall	bindall
argargamant	kargamant
levrambrouger	levrambrouger
strgann	sterganni
souleged	soulegenn
difla	diflav
zisc'hlea	dizlea
boukidibran	bokedbran
kolloukousked	koll
alijein	aliji
eunniverdiventa	divent
ankohin	ankouazhin
lerennet	lrennet
dizeunet	dizaonet
buhugennein	buzhugennabuzhugennatbuzhugenni
garved	garved
jenoflez	jenoflezenn
frouezet	frouezhet
lemmlivris	livrizh
daskor	daskordakor
dichansazobetvar	dichas
pizeg	pizeg
digor	digor
enflistra	enflistra
drail	drailh
rebechadou	rebechad
skolaj	skolaj
dijog	dijog
divorfil	divorfil
pollen	pollen
humgisneas	giznevezi
diforc'hein	diforc'hidiforc'hadiforc'h
gwenojenn	gwenodenn
zifindaoni	difindaoni
eurveilhnizat	milinnizat
goulerc'her	goulerc'her
digoga	digoga
dihaill	dic'hailh
eurvapeur	bapeur
SperedSantel	SperedSantel
fraovellad	fraovellat
abepmod	abepmod
Froj	fraoj
termon	termon
li	li
karno	karnod
zonet	sonet
nijerez	nijerez
ibereg	ibereg
Fongn	fogn
falleuruzamant	falleruzamant
hirisaden	hirisadenn
peskedussat	peskedusaat
gwatal	gwatal
goavenned	goavennet
chifein	chifachifalchifi
deverranseu	diverras
kathedral	katedral
Krebien	krebien
arvastingaj	bastingaj
disorb	disorb
chakertrousk	chaoker
anamzerwechall	amzer
adrizilhonne	trizilhona
teusk	teusknoz
Obererouz	rouz
amiot	amiod
hirgamm	hirgamm
berrbredo	berrbred
laka'ta	'ta
marmouzerez	marmouzerezh
karbur	karbur
digeliener	digeliener
koc'hiennek	koc'hienek
kolzac'h	kolzac'h
kammbroud	kammbroud
marc'hourgouilh	marc'hourgouilh
Leazgwedenn	goedenn
bimbellik	bimbellik
tabore	tabore
Erjennet	erjennat
sulaouret	soulaouret
apertik	apertig
gorreDoue	gorreDoue
demrouz	damrous
divorfil	divorfil
titouri	titouri
Pere	pere
nennig	nennig
prizoniet	prizoniet
truchiri	truchiri
c'hoarzgoab	goap
Tiouital	tiouital
gouez	gouez
eteoenerout	roud
sukraj	sukraj
brezelarGroaz	kroaz
dihranein	dic'hreunia
fisel	Fisel
anterc'hoarezed	hanterc'hoar
kozeuz	kaozes
berton	berton
divaouzein	divavouzi
digouezet	digouezha
dibradadur	dibradadurio
arummdarumm	arummdarumm
zidamma	didammadidammi
diharzadur	dic'harzhadur
inged	inged
dispountaz	dispontidisponta
boslagout	boslagout
abeurzigoras	peurzigeri
zicheta	dicheda
ifomet	ifametifomet
biat	bezia
Kerne	KernevKerne
arc'hrenamantdouar	krenamantdouar
argontelleeun	kontelleeun
eurveilavel	meilhavel
eeunhageeun	eeunhageeun
Sezon	saesonsaezon
veri	merameri
adbueet	advuheza
aziruduilh	diruduilha
aarounas	arouni
egouskmintin	kouskmintin
chigogokenn	chigolokenn
ober	ober
dourbeo	dourbev
gronchet	grojet
urvrogonen	brogonenn
Turlubanein	turlebani
Tonn	tonn
Mison	mison
digoust	digoust
dianvzerion	diavaezour
tiroditirodi	tiroditirodi
seulgoasoc'h	seul
gevrmor	gavrvor
Dargaig	dregaerik
bouederh	bouederc'h
rondell	rondell
Me'rafoeltrfout	foeltrfoutr
dourbill	dourbilh
startt	startaat
jipot	chipot
dichiket	dichiket
tapeton	tapet
saetoh	savet
yunet	yunayuniyun
ezifienn	difienni
paad	pavad
rubanek	rubanek
fardet	fardet
kleian	klei
damgompes	damgompez
omestrizi	mestrezenn
Flipaterez	flipataerezh
dioap	dic'hoap
Gac'h	gac'hgarc'h
Ivel	Ivel
firitel	firitell
nebon	nebaon
souraelek	souravelek
difizians	difizias
paotrmalour	paotrmaler
bouilhhabouilh	bouilhhabouilh
touflean	touflezatouflezi
anunan	anunan
toullalludu	toullalludu
emgannein	emgannaemganni
esa	esa
trist	trist
doupina	toupina
koulz'zobet	koulz
liarda	liarda
skotet	skotet
ezivaltr	divaltri
batorlet	batorellet
To	to
meHonfortour	koforter
huhmiziad	c'hwec'hmiziad
zoulltrap	toulltrap
subjektivel	subjektivel
darempreder	darempreder
dekoransou	dekoras
truilhennek	truilhennek
kokotr	kokoter
eurgrennerez	krennerez
yeu	yeu
humhersal	hersalhersahersi
Seblant	seblant
avaloranjez	avalorajez
diverglein	divergladivergli
oldeur	oldour
arblasennad	plasennad
bourjin	bourjin
egul	kulakuli
jaujabl	jaojapl
rahkoed	razhkoad
ltierez	laetierez
gouez	gouez
regali	regali
red	red
kamambrerez	kamambrerezh
lizidant	lizidant
klanched	klached
pompadryen	pompader
sklasi	sklasasklasi
divarvelez	divarvelezh
diwrizienn	diwrizienn
Sederaat	sederaat
kreiza	kreiza
erbitauded	pitaod
Konfilis	kofilis
flibouz	flibouz
Spurmantein	spurmanti
foarvez	foarvezh
dic'hailhet	dic'hailhet
goueria	goueria
loaioranet	loaraned
c'hopal	hopalhopahopi
enemzantelt	santelaat
dizintonet	dizentonnet
foc'het	foc'het
zifrrr	difreri
c'houezadenn	c'hwezadenn
zigraza	digraza
kraboseg	kraboseg
aflao	flav
Blejblejblej	blej
salad	salead
stokenn	stokenn
Eurwechanamzer	amzer
rosuku	rozuku
tronkon	tronkon
dalc'hmat	dalbat
boulouzennet	boulouzennet
takenour	takeneour
chifa	chifachifalchifi
avgad	avegad
tarvea	tarvea
abellgoz	abellgozh
gouelmiklez	gouelMikaelez
anaoudeien	anaoudeg
eihdiad	eizhteziad
abaffet	abafet
lezennadurez	lezennadurezh
mank	mank
izelekaat	izelekaat
avranskedilho	braskedilhat
kriphakrap	kriphakrap
deusouket	daouchouket
ampeleur	ampereur
poanc'houzoug	poanc'houzoug
tefnen	tefen
kafeta	kafeta
immobuet	immobuet
aadkrapas	adkrapa
glubetbrein	brein
gwallamzer	gwallamzer
italiek	italieg
taltous	taltouz
chetet	chetet
tosennek	tosennek
lafourieg	lafourieg
Erc'houlzoze	koulz
merhat	moarvat
laezgwedenn	goedenn
Sabardi	sabardi
lorbour	lorber
dirastell	dirastell
dourasennek	dourasennek
diroudennet	diroudennet
Begmennmenn	begmennmenn
reklem	reklem
kantvloaz	kantvloaziat
zistira	distira
taolbouh	taolbouc'h
gwrat	gwerat
difrigas	difrigas
brignennigueu	brignenennbrignonenn
Koulzazo	koulz
divroidi	divroaddivroiad
iverzoniad	iwerzhonat
klotennadur	klotennadur
gaouierez	gaouierezh
amgrasted	emc'hrausted
Belbeter	belbeter
damnac'hdavin	damnac'hdavin
toc'hor	toc'hor
dastumad	dastumad
garzennet	garzenni
muzikerez	muzikerezh
anouedet	anouedet
Sulfat	sulfat
peuk	peuk
dero	derv
dihraiet	dic'hravia
Bizig	bisig
douarkoll	douarkoll
begmimi	mimi
pifon	pifon
bidanell	bidanell
gourzevel	goursevel
dibgereh	dibegerezh
zabatid'ezo	sabati
paravia	paravia
arblaen	arblaen
Choupa	choupa
Youenn	Youenn
amska	amskav
koant	koant
zulBleuou	SulBleunioSularBleunio
lug	lug
peurrest	peurrest
Aedik	eidik
kostellinou	kostelino
furzot	fursot
skorbut	skorbut
Fed'amtroud'andoulle	feda'maotroud'andoulle
heolpalmez	eoulpalmez
marc'hloar	marc'hloar
dialiein	dialiadialii
parkarmaro	parkarmarv
evel	evel
me'zoali	ali
rannvor	rannvor
alarc'hez	alarc'hez
Logiviiz	Logiviiz
distrap	distrap
pskejen	peskejen
chelbouch	chelbouch
bemdeizDoue	bemdezDoue
lonigou	loanigo
tifeti	difeti
melended	melended
forn	forn
jomablas	ablas
oberiantiz	oberiantiz
ed	sinez
disti	disteidistoi
lagouta	lagouta
oberbilh	bilh
menon	menon
personkanton	personkanton
zifizianz	difizias
gonferansi	koferasi
warozrankilite	trankilite
arbeilhasken	peilhastenn
diboel	diboell
fidezoupen	fidezoupenn
arvarg	arvarg
chassa	chasa
pichard	pichard
poanbleo	poanvlev
Tenaenneu	tanavenn
glustreu	gloestr
bleijereheu	blejerezh
revorenn	revorenn
ekuit	ekuit
dihu	diwez
Kravazpostek	kravazhpostek
vrogarourien	brogarour
da	rei
donteveizd'eza	meizmez
lonkaj	lonkaj
eu	bir
goulanter	goullonder
aziriklas	dirikla
didch	didech
faegegeg	faegaegaeg
Toubrata	toubrata
dadkrampoez	tadkrampouezh
dichalou	dichalon
emstoui	emstoui
androgam	trogamm
emeusgrtdomaig	domaj
fidempret	fidampret
arummadou	arummado
pe	pe
borzevellecg	borzevelleg
amodelled	amoedell
ijinourien	ijinour
difoset	difoset
enorborz	dorborzh
fuzik	fuzik
goc'ha	kaoc'ha
fidadoullou	fidadoullou
richodellrichodellik	richodell
didalvouda	didalvoud
adunani	adunani
eilkenta	eilkenta
mouchennou	mouchenn
nefelleketgantan	fellelfelloutfallout
hu	huanhue
faobian	favbihan
frhen	frouezhenn
harpan	harpaharpi
gweturioumobil	gweturvobil
garante	karantez
adrainvat	adrainvat
patrour	patererpaterour
Squilnnneu	skilenn
Goneri	Goneri
daonik	daonik
touldouar	toulldouar
truantesed	truantez
lostenna	lostennilostenna
enemchifal	chifachifalchifi
skasein	skasi
brogarourion	brogarour
brezida	prezida
begad	begad
ratozi	ratozhi
Lamperez	lamperez
vourlenva	morleva
kendruezi	kendruezi
dic'hreunian	dic'hreunia
vann	bannneud
dadlikokenn	tadlikokenn
ijinprena	ijinprena
hadlanna	hadlanna
euntaolchao	chav
kornpleg	kornpleg
mut	mut
keltiek	keltiekkeltek
prehsioneu	predesionprehesion
rugagni	rugagni
Imoli	imoli
ziroc'hal	diroc'haldiroc'hatdiroc'hi
paotregerniou	paotregernio
enemguilhe	kuilhakuilhi
butunfri	butunfri
chivouster	chivouster
askouarn	askouarn
arranket	arenket
hanteret	hanterahanteri
ehoalimur	gwallimori
stranet	stranet
reiarstoc'hda	stoc'h
bre	brae
fouill	fouilh
savtaol	savtaol
argoc'henenn	koc'henenn
eilpennad	eilpennadur
syndiket	sindiket
baltasoh	baltaz
gwezflimmin	flimin
Moeltr	moeltr
gourbleget	goubleget
bigodennres	bigodennerezh
rustedigez	rustedigezh
karadek	karadek
lar	laer
diharak	diharak
oberpant	pant
Skarpijer	skarpijer
strihennek	strizhennek
urhardel	kardell
buanhabuan	buanhabuan
divrerien	divroer
pub	pub
mudez	mudez
zer	serr
daouved	daouved
steo	steo
zirinkt	dirinkat
hwirikal	gwirikalgwirikat
artiklarmaro	artikl
hohgou	gouez
vourouellat	bourouellatbourouella
difidel	difidel
houarngwestign	houarngweskenn
aenep	froudenna
souezetd	souezhetaat
eurc'hac'her	kac'her
skarmot	skarmotal
goridik	goridik
pevod	pevod
dilojemant	dilojamant
itic	itik
annon	annon
uheldadou	uheldad
aentize	entiza
Flouraat	flouraat
Jastra	jastra
pastellek	pastellek
Sklenta	sklenta
rampog	rampeg
enhagen	eeunhageeun
rederienoreor	redererevr
gourigellet	gourigellat
Didrec'h	didrec'h
Pellmellktigell	pellmellkaotigell
Azeeh	azevezh
ekonomikel	ekonomikel
sen	sin
Bn	bon
kertrius	kerterius
edachenn	tachenni
krabanaouek	krabanaouek
enemzonjal	sojalsoji
peurziesa	peurziaes
Moulbennet	moulbennet
Nagevitse	evitse
diiahus	diyac'hus
m'	er
ervarez	marvez
sac'hnouenn	sac'hnouenn
divastar	divastar
fonnabl	fonnapl
diamodein	diamoedi
varbarentegant	parentez
touribellet	touribellet
dic'hiz	dic'hiz
fic'hellat	fic'hellat
bignedbignet	bigned
fourniet	fornia
gwirtreiz	gwirtreizh
Tinta	tintaltinta
diser	diser
parea	parea
c'horreDoue	gorreDoue
addastum	addastum
mildakonet	takonet
gousketkalet	kousketkouski
paron	paron
Devor	devor
boufam	boufam
bareg	barveg
Menammet	manami
botokeno	botezkeno
amunuzerez	amunuzerezh
sklep	sklep
lasad	lasad
simbolenn	simbolenn
'nemdanan	tana
etarlamme	darlammat
korfadurel	korfadurel
Sklisenni	sklisennasklisenni
tigilha	digilha
mekanik	mekanik
seiennour	seizenner
uraniom	uraniom
FanchKouer	Fach
arc'haeraduriou	kaeradur
hirnez	hirnezh
dourjost	jostr
bridet	bridet
Skor	Skorv
lezverc'hkaer	lezverc'hkaer
Tuen	tuenn
chikolodennou	chikolodenn
diankachou	diankajo
maenboueta	maenboueta
tadargaou	tadargaouargevier
arandone	randoni
zispont	dispont
blazus	blazus
rederbro	rederbro
foudralis	foudralis
dilabour	dilabour
mourouzek	mourouzek
Digoata	digoata
emgannlec'h	emgannlec'h
aadsailhas	adsailha
auglenneu	oglenn
menhigolen	maenhigolenn
Adourou	adc'horo
Risket	risket
Sterek	strek
divent	divent
peurc'hreat	peurc'hraet
kohlbihan	kole
arwezennad	gwezennad
lidlazet	lidlazha
amzerservij	amzer
zizraenein	dizraena
livet	livet
frelom	frelom
Divleupet	divleupa
ilgreh	ilgrec'hildrec'h
fouhatat	fouezhata
Elvennvatt	elvenn
dirabas	dirabas
yec'hedouriez	yec'hedouriezh
lpen	loupenn
gouez	gouez
etres	tres
Eliboubana	Eliboubana
ion	toronour
'z	z'
han	ha
serbeg	serbeg
ndonn	ton
genganv	kengav
difoac'het	difoac'het
kadaou	kad
lammkalon	lammkalon
estrebed	estrebedestreved
didallan	dizalla
touellet	touellet
adlsur	adaolsur
leskadurez	leskadurezh
kalite	kalite
lidoukanv	lidkav
goet	goet
Adastennet	adastenn
siva	sivia
kantvloaziek	kantvloaziek
goudor	goudor
ivantorier	invantorier
urvagdrag	bagdrag
eneet	enea
Dampasion	dampasion
arvre	arvrec'h
Ich	ich
agorfmaro	agorfmarv
paotrmicher	paotrmicher
urbladenn	pladenn
Skridplen	skridplaen
Perseptor	perseptor
stonka	stonka
beghent	hent
stalen	stalenn
Taluout	talvout
fichedad	fichedad
diharak	diharak
kosthakostez	kostezkostez
zebri	amzer
divodest	divodest
skeriou	skerio
dourkoueor	dourkouevr
sederd	sederaat
enheeaz	aez
tallaskertarlasker	tarlasker
rozel	rozellgrampouezh
bourreler	boureller
dommaat	tommaat
taoletspled	spled
linzereost	liseleost
Avezul	muzul
skuizhadenn	skuizhadenn
eurc'hastellkrenv	kastellkrev
strapa	strapastrapat
divorz	divors
maenkoarz	kouarz
trogorn	trogorntrogorn
skluzier	skluzierskluzer
gloanennein	gloanennigwlanenni
Kasant	kasant
bioka	piokaa
hoaretavgad	begad
Drasksaoz	drasksaoz
trogorn	trogorntrogorn
picqailhryen	pikailher
Madedoue	madedoue
pegoulz	pegoulz
besantroat	biztroad
divourusted	divourrusted
patriarch	patriarch
dilabour	dilabour
c'hoantaennou	c'hoantaenn
c'hantennou	kantenn
amiapted	amiaplded
kammed	kammed
Ampar	ampar
digloz	digloz
Brusk	brusk
togsistr	togsistr
liren	lierenn
harpa	harpaharpi
alaer	alaer
dagoll	koll
kakaouet	kakaouet
fiezdoged	fiezdoged
argraouengouk	kraoennc'houzoug
plavet	plavet
pinijennuz	pinijennus
dic'hout	dic'hout
genoukamm	genokamm
lor	lore
all	all
rebechou	rebech
pallennvoger	pallennmoger
Tregidel	Tregedel
skod	skod
mantilh	mantilh
reihmat	reizh
adistok	distokadistoki
storlok	storlok
solierad	solierad
degasad	degasad
kalkuta	kalkuta
ekuit	ekuit
negazanket	kazoutkazet
plac'hedaod	plac'haod
gougigru	gouzougigruz
aforhadeu	aforc'hado
enemharpa	harpaharpi
zutadenne	sutadenni
kanastr	kanastr
Digocha	digocha
meinrodell	rodell
Leurenn	leurenn
ewalgein	gwalgein
gouzourek	gouzourek
wardoull	wardoull
kube	kubikuba
Torcha	torchatorchi
Arwregyaouank	gwregyaouank
zadornFask	SadornFask
lousoni	lousoni
huvelez	huelez
henthouarn	henthouarn
dourdiwan	dourdiwan
republikan	republikan
euzandispar	dispar
fogn	fogn
Elias	Eliaz
traket	tranket
enfidamdision	efidamdision
zifounna	difonna
solutaet	solutaat
argarantezvro	karantezvro
goannia	koaniakoagnikoana
coll	koll
soulbedein	soulbedi
lunetour	luneder
Dizale	dizale
harlui	harluaharlui
ewrinvallont	gwrinvalla
oadvez	oadvezh
bosad	bosad
hagese	hagese
yalpa	yalpayalpi
baltas	baltaz
futuer	futuer
bailhad	bailhad
profsiein	profesiaprofesii
dantellet	dantellet
tarhdigorein	tarzhdigeri
nizien	nizien
spilhennok	spilhennek
blaoahet	braouac'het
tljech	taolsach
trabaser	trabaser
gwall	gwall
gournisennou	gournisenn
efontegandarvez	fontafonti
peurvouget	peurvouga
batono	patono
soudardiez	soudardiezh
sklujer	skluzierskluzer
laka'ta	'ta
maillet	mailhi
berhindetat	pirc'hindetat
erminiget	erminiget
reveulzi	reveulzi
foarvez	foarvezh
haoleg	kaoleg
eurveselier	beselier
keulennet	kaoulennet
izeuet	ezevi
askign	askign
daklak	daklakdaklao
eben	eben
gamachou	gamachenn
strinkadennou	strinkadenn
adarmead	adarmead
leizet	leizhet
aliou	ali
spgereh	spegerezh
gerheg	kerheg
gazeni	kazeni
diskolperien	diskolper
ourladennuz	houladennus
gwignal	gwignalgwigni
kraonmor	kraomor
sac'ha	sac'ha
satordampet	satordampet
Sebezus	sebezus
abafet	abafet
poazh	poazh
zroukhoala	droukhoala
merc'herarmeur	Merc'her
Monetd'erflosker	flosker
garantezvro	karantezvro
goumpagnunez	kompagnunezh
adermone	termona
ablas	ablas
karrakenn	karakenn
kastrouillek	kastrouilhek
karnet	karnet
efuzuillaz	fuzuilha
bornet	bornet
predmintin	predmintin
arc'halbornio	kalborn
Lagan	lagan
abaze	abazo
triliou	triliv
sasun	sasun
dizinoui	dizenoei
kostiek	kosteziek
anamreuta	reutaat
leustreugenn	lustrugenn
dizware	disgwarez
treuzet	treuzitreuza
disane	dizanavez
c'hevarc'ha	kevarc'ha
diveget	diveget
spurji	spurjaspurji
rimastellat	rimastellat
eurbarti	parti
butunmarmouz	butunmarmouz
enememellent	emelloutemella
Brammsahad	brammsac'hat
dizanaoudegez	dizanaoudegezh
lostubelejen	lostbeleg
entenn	eeuntenn
dourista	tourista
didok	didog
Ourbabanchou	orbabacho
agarradou	agarrado
eurc'hrapad	krapad
astrink	astrink
touleter	toulleter
hros	gros
peurachou	peuraj
diaheurtein	diaheurti
taltouin	taltouin
rata	rata
Rovijenn	roviennrovijenn
astribouilhstrabouilh	astribouilhstrabouilh
gantolgoar	kantolgoar
krochetat	krochetat
toulleubr	toullber
karnaj	karnaj
hanterkantvedenni	hanterkantvedenni
menoneu	menon
feurlac'ha	peurlazha
visou	bis
zilvidigez	silvidigezh
Senven	Senven
hanterbarea	hanterbarea
Rampla	rampla
troidellek	troidellek
maenenvor	maenevor
paperouskignerez	skignerezh
alintre	lintralintri
Boudadouf	boudadouf
ed	taer
Danadenn	Danaidenn
asildasil	sil
kognellet	kognellat
eurvourc'hadenn	bourc'hadenn
hanaedigeh	anavedigezh
kluc'hun	kluc'hunenn
urhidu	kidu
penpill	pempilh
labous	labous
agreizm'	agreiz
stokerez	stokerez
Divrasa	divrazadivrazi
koanian	koaniakoagnikoana
perier	perier
Dioustet	dic'houstet
barrenkezeg	barrenngezeg
erhelid	kellid
pafelld'	fellelfelloutfallout
trabaser	trabaser
Federaliezh	federaliezh
morzha	morzha
teu	binot
nondediah	nondediac'h
paotretarC'huzHeol	paotrarc'huzhheol
diharakoh	diharak
kozeadennou	kaozeadenn
loueren	loerenn
karabinenn	karabinenn
milon	milon
erhoalh	rwalc'h
soudanennet	soutanenni
chaous	chaous
abennneuze	abennneuze
kroazadeg	kroaziadeg
geriaoua	geriaoua
feri	feri
diziaolein	diziaouli
gorreaoter	aoter
similha	similha
dichetet	dicheda
skui	skuizha
frechou	pres
tortuilhet	tortuilhet
romanek	romanek
munuzein	munuzatmunuziamunuzi
dibunet	dibunet
mailhuret	mailhuret
mz	maez
poupon	poupon
megantifi	kantdifia
brasigellou	brasigell
diouskouarnek	divskouarnek
chojig	choj
enemziavezi	diavaezi
urbistronken	pistronkenn
sebeliadur	sebeliadur
zifourbelle	difourbella
gouiliaden	goueliadenn
gamdroeu	kammdro
kumun	kumun
strinkellika	strinkellikatstrinkellika
drelar	laer
pabori	pabori
warhednebeud	warhednebeut
eu	taset
brerion	diorbler
rasklenn	rasklenn
wigour	gwigour
Bidiez	bidiez
matok	mantok
advuhezekaat	advuhezekaat
dizesperet	dizesperet
diouzandiwezadou	diwezhad
resuour	resever
duardet	duardi
flipatus	flipatus
hefennkuch	pennkuch
arc'hollou	koll
tlru	taolru
krouglec'h	krouglec'h
aeilrenk	aeilrenk
profesiou	profesi
hurrus	hurus
doanik	doanik
sapek	sapek
kied	keved
seulen	soulenn
grabeta	krabeta
bepenamzer	amzer
diskou	disk
stravaget	stravaget
ampavan	ampavan
boell	aboell
ion	eiler
matorguenn	torgenni
kelion	keliensantMark
finvaden	fivadenn
engroez	engroez
arhuellad	arwellad
rukunus	rukunus
demc'holoet	damc'holoet
diouzandiwezadou	diwezhad
melchennou	melchon
treufleza	treufleza
Razhouarn	razhouarn
gorrig	korr
doustadik	doustadik
stoc'h	stoc'h
homeopatek	homeopatek
diamen	diamen
reputet	reputareputi
aziharlute	diharluti
mobilier	mobilier
beurblanta	peurblanta
distoc'h	distoc'h
zihernein	diherni
mntosel	tosel
Ivona	Ivona
diweskan	diweska
warrk	warraok
amzernevez	amzernevez
bransibransel	brasibrasell
poangostez	poangostez
seller	seller
disudard	disoudard
en	estren
zinket	zinket
gouilMariaenAvent	GouelMariaanAzvent
fenestri	fenestr
echomrelz	relez
Tremaouezan	Tremaouezan
nondedioust	nondedioust
LannGibin	lanngibin
aziskan	aziskan
diamn	diamen
mignerez	mignerezh
politikacherien	politikajer
Melon	Melon
kenetrezo	kenetre
cheul	cheul
Banngomzerez	banngomzerezh
c'hoariell	c'hoariell
gallegsaout	galleg
marfad	moarvat
nneu	oglenn
eurwabrenen	koabrenenn
tivergla	divergladivergli
butunkarot	karot
Divadin	divadin
merc'her	Merc'her
speget	speget
droukizili	drougizili
didrec'h	didrec'h
foug	foug
triket	triket
warhokorre	gorre
Biel	Biel
avnfians	avenefias
laka'ta	'ta
distoket	distokadistoki
ahanemen	ac'halemaac'hanema
seziset	seziza
toreg	toreg
beurzalla	peurzalla
tibordi	dibordi
nondedelle	nondedelle
boutellet	boutellet
huskellet	huskellat
brein	brein
dallet	dallet
barazou	barazh
metrkub	kub
bourrus	bourrus
n'ekuir	nekwir
arvalachenn	palachenn
hohen	hoc'henn
ibraozeier	braozeg
lustrugen	lustrugenn
niezigoareizou	digoraiza
spilhokraf	spilhenngraf
hudurnerez	hudurnerezh
romanaet	romanaat
fez	fez
peurbadout	peurbadout
karnet	karnet
dadrukan	truka
moc'hdena	moc'hdena
peogwir	peogwir
arab	arab
tourtan	tourtan
Kammo	kamm
Laouik	Laouig
Ermaeziadeg	ermeziadeg
aleun	aleun
Atom	atom
eflikflak	flikflaki
tarzhgouloanNorz	tarzhgouloannorzh
dabonet	dabonet
kleret	kleret
hentkornandoned	hentkornandoned
etiroufla	diroufla
strobineller	strobineller
keltiek	keltiekkeltek
Sakrenonde	sakrenonde
amguzet	amguzhet
mouchetet	moucheta
splanderiou	splannder
flechaoui	flechaoui
mestrkeginer	mestrkeginer
bigod	bigod
turierdouar	turierdouar
felonnetfolonnet	felonet
Millig	millig
pifida	pibida
pitouilh	pitouilh
paravia	paravia
fasellmin	fasellmaen
bleuneve	bleuvnevez
kenemsevel	kenemsevel
bimant	pimant
avostad	avostad
Berber	berber
trabas	trabas
gwardkloued	gwardkloued
klaoiek	klaouiek
flanel	flanell
peursklaer	peursklaer
komprenet	komprenet
ingwelapl	ingwelapl
ojivek	ojivek
Dallouhet	dallouc'het
peurunvani	peurunvani
Bonoviz	Bonoviz
mouchennvin	mouchennvin
ekeitma	ekeit
kontaj	kontaj
taoladur	taoladur
prosezal	proseziprosezal
kuzuliomeur	Kuzulmeur
divoeded	divouedet
asantamant	asantamant
difradenneu	diferadenn
kamaldolad	kamaldolad
ampusturi	ampusturi
digompez	digompez
demvoull	damvoull
divignon	divignon
gwezenngoton	gwezkoton
advoulladur	advoulladur
taoubenni	daoubenni
zonjen	sojenn
bikorbi	begkorbin
kordennad	kordennad
zrailhou	drailh
adrokein	adrokein
aziskoulmaz	diskoulmadiskoulm
maneur	maneur
laes	laes
rouzannoz	rouzannoz
Blank	blank
agorvroched	agorfroched
gloria	gloria
disternacha	disternaja
guerherion	gwerzher
c'hoarzingoap	goap
kedezwengolo	kedez
raklet	rakled
c'hallegsaout	galleg
berrwelerezh	berrwelerezh
goal	gwall
chafft	chafod
larderez	larderezh
malaga	malaga
drailhhavr	havr
alvanet	alvaonet
danvezlezenn	danvezlezenn
c'hravetta	garveta
arboellentez	arboellentez
Hervek	Herve
digeltieket	digeltiekaat
jolorius	cholorius
Digompagnun	digompagnun
diaveazbro	diavaezbro
heunan	eunan
nret	neret
kovilis	kofilis
kagalet	kagalet
anteri	hanterahanteri
riolen	riolenn
loufog	loufek
korfadur	korfadur
kailhennou	kailhenn
anhagan	eeunhageeun
penent	penent
digoavennet	digoavenet
gwelcha	gwelchagwelchat
malaoued	malaouan
okitaneg	okitaneg
Oc'hu	oc'hu
andoufiou	andouv
distoladenn	distaoladenn
arveinruilh	ruilh
derobe	derobe
pln	plaen
korvadereh	korfaderezh
eurblasennad	plasennad
ouk	ouek
dukel	kel
ezeoeatheskiantvaddigant	skiantvat
bragezrodellek	bragezrodellek
toullseo	toullsev
lagoutcit	lagoutsistr
milkrampohen	krampouezhenn
ploborennet	klogorennet
stouvet	stouvet
digoupabl	digoupapl
ziriska	diriska
Kej	kej
Aev	ae
kaskalat	kaskalat
mud	mut
divourrus	divourrus
pac'hanavezaswar	anavezoutanavoutanaout
advont	advont
metrel	metrel
goet	goet
teal	teal
undoupig	toupig
dr	dreog
dourjost	dourjostr
soupleseou	soupleseo
gouarner	gouarner
dusumok	tuzumek
mik	mik
marc'houservich	marc'hservij
lec'heria	lerc'heria
girohgir	gerouzhger
Tric'hant	tric'hant
dembar	dambar
fletenn	fletenn
brizenna	prizenna
debret	debret
ddennet	dedennadedenn
Skorv	Skorv
difurmet	difurmet
broadel	broadel
diforh	diforc'hidiforc'hadiforc'h
Bug	bug
bral	berravel
dourfank	dourfank
prederen	prederenn
diboultrenner	diboultrenner
aflao	flav
filimus	filimus
urhuloteu	kuloto
Kou	Kou
Eizdeziek	eizhteziek
diyalc'ha	diyalc'ha
skasad	skasad
kenstrivadegou	kenstrivadeg
Andreilhenn	treilhenn
eurc'hliket	kliked
okinoch	kinochenn
disporaill	disporailh
gwrizioured	gwriziennred
Fouban	foubenn
Plouenaniz	Plouenaniz
diharak	diharak
Achuer	echuerachuer
frtet	frtet
fleg	fleg
rampa	rampla
diharak	diharak
kasell	kasell
arneek	arnevek
gerion	bagour
Oustrevit	estrevit
Japon	Japon
krougapl	krougapl
Ekonomiezh	ekonomiezh
speurm	speurm
ledrinen	ledrinenn
pichota	pichota
asklasas	sklasasklasi
anunan	anunan
rampsek	ramzek
nezigounnarasket	digounnari
venik	gwennig
garved	garved
sclizennei	sklisennasklisenni
abeurwastas	peurwasta
bouedgoanv	bouedgoav
trehatre	trehatre
digoumoul	digoumoul
Drible	drible
fozbevenn	fozbevenn
glasiad	klaziad
Makaroni	makaroni
touer	touer
chrvaden	chervadenn
amzer	amzer
arumdarum	arummdarumm
Chaogenta	chaogenta
peurnettt	peurnaetaat
miton	miton
Tarhourkeneu	tarzherkrao
vezian	bezia
karre	karrezadur
dourvitriol	dourvitriol
punellat	punellat
leurennbrezeg	leurennbrezeg
herrder	herrder
Moranamb	moreni
asperj	asperj
bre	brec'hkarr
diroufenna	diroufenna
pikvirgulenn	pikvirgulenn
Dioranein	diorvani
gwedennek	goedennek
gouzer	gouzer
Aflao	flav
housunan	hoc'hunan
dizisk	dizesk
bet	bet
listrikegin	lestrkegin
boulverz	boulvers
lodennet	lodennet
adgoestlan	adouestla
paravia	paravia
difeiz	difeiz
bouc'haboc'ha	bouc'ha
filochi	filochi
peurvouget	peurvouga
tivinet	divini
avad	avat
sovein	saovi
dornouzdorn	dornouzhdorn
Ministrerezh	ministrerezh
goui	gouez
Lowitous	laouitouz
zapaturi	sabaturi
niverusaat	niverusaat
naerbuton	naerbuton
eno	eno
turmuch	turmuch
listrichacha	lestrsacha
koana	koaniakoagnikoana
demvaro	damvarv
agonfont	kofont
molumet	molumet
flibous	flibous
brecher	prechaprechi
digasoni	digasoni
marc'houantier	marc'hantier
c'hrammadeg	gramadeg
didoumpi	toumpi
Nonna	Nonna
wardastoun	wardaston
reper	reper
Karellig	karellig
estlammetoll	estlammet
distremen	distremen
avaleg	avaleg
doubleviou	doublevio
estoneg	estoneg
dreanteut	teut
gealanebrel	KelanEbrel
Difourm	difrom
fleurkleier	fleurkleier
ifomet	ifametifomet
mem	meme
kouskmerenn	kouskmerenn
skarz	skarzh
peurventet	peurwenta
okegus	kegusenn
neidagliou	neidagliou
p	pe
rukunus	rukunus
bankerien	bankerbankour
zifza	difaezha
grafignat	krafignatkrafignikrafignakrafignal
flapaflepa	flipaflipatflipi
visat	bizat
draster	draster
huit	c'hwit
paravarnan	para
armehet	armerzhet
katarek	katarek
addizrei	addizrei
modpevod	modpevod
italian	italian
hanterbouez	hanterbouez
alazki	alazhki(klav)
stoc'h	stoc'h
snobiezh	snobiezh
d'enemanaout	anavezoutanavoutanaout
varnebeut	warnebeut
futetaet	futetaet
tuper	tumper
meneztanek	meneztanek
difla	diflav
Chalpat	chalpat
kardredan	karrdredan
drniad	treniad
rip	rip
Divoemet	divoemet
nwet	nevi
maillein	mailhi
gos	gos
personkanton	personkanton
avandavan	mann
aglaskas	trabas
tresennour	tresennour
kabalerezh	kabalerezh
speurm	speurm
Heven	Even
lavarhadislavar	lavardislavar
tolerans	toleras
bouda	bouda
ndet	neudet
diviton	diviton
Ac'ha	ac'haac'han
goaf	goaf
tdavann	mann
Disabatui	disabatui
Dikulez	dikulez
bolboset	bolboset
arc'hragou	krago
helez	helez
futal	futeal
pastilhez	pastilhezenn
pidadap	pidadap
labousHorZalver	labousighorSalver
maezomp	maez
digoliera	digoliera
sapretoutik	sapretoutik
eurc'hoser	koser
robinenn	robinenn
bioulart	bioulart
Ahe	ahe
gaouet	gaoui
Klimisia	klimisia
ententegez	intentegezh
adreuzdidreuz	treuzdidreuz
chipolata	chipolata
dislenn	dislenn
lezvarn	lezvarn
postgul	postgwele
koltaret	koltari
trepet	trepet
arc'halvar	kalvar
talk	talk
romancheg	romacheg
ignamez	ignamez
PevareAmzer	Pevareamzer
diziazez	diziazez
Goion	goion
dournet	dornet
brein	brein
o	kotad
stouffou	stouv
diratoz	diratozh
spioni	spionaspioni
amboubal	amboubal
brabanser	brabaser
mobilier	mobilier
Stoc'ha	stoc'ha
dizesk	dizesk
andremenidi	tremeniad
obrstrol	stroll
Eflam	Eflamm
anDorzhellegezh	torzhellegezh
plaouf	plaouf
bonimal	bonimal
komplidi	komplidi
palouar	palouer
foulet	foulet
abazeukah	abazokazh
fistomeg	pistomeg
anor	sterndor
azibouez	dibouez
erbederez	erbederezh
selleno	eno
didres	didres
pevaremestr	pevaremestr
entud'armaez	maez
divrezonekadur	divrezhonekadur
Kalonein	kaloni
kraouiet	kraouia
divrec'hailh	divrec'hailh
botan	bota
terson	terson
daletoc'h	dalet
tius	tius
rousenned	rouzenn
btis	batis
gozaked	Kozak
Fidajampi	fidajampi
lammpenn	lammpenn
kotat	koataat
balourskritelleu	baleerskritello
bouc'haboc'ha	bouc'ha
dineyzryen	dineizherdineizhier
grochet	grojet
distrogozh	distrogozh
degours	koulz
Neal	neal
agreizpenn	agreizpenn
argenyezoniez	kenyezhoniezh
freselat	freselatfreseli
analiza	analiza
diastal	diastal
Dallouhein	dallouc'hi
wardirabaz	dirabas
bredik	bredik
ehochell	hoskellathoskelli
Avgad	avegad
ranjennet	rajennet
mo	mona
Pethapet	pet
reihmat	reizh
elog	loegi
Aljemant	alejamant
drogereh	drogerezh
dizefot	dizefot
merhetereh	merc'hetaerezh
sevennet	sevenet
keilenglaou	kelienglaou
didal	didal
galpad	klapad
Lezvarnarbinijen	lezvarn
peurgloza	peurgloza
peurzistanka	peurzistanka
toulkardel	kardell
bugulseud	bugulsaout
glaouaer	glaouaerglaouer
taolru	taolru
iohet	yoc'het
hzrechil	treuzkila
mesfetet	mesfeta
ezistapon	distaponi
Kad	kad
brikouier	brikiobriko
gr	grez
kloarekeit	klouarekaat
rouf	rouf
lazeria	lazeria
skognad	skognad
Urvorgaolenn	morgaoulenn
BroSkos	BroSkos
havouezenn	havouezenn
lonedd	loendozv
eurgildroen	kildroenn
stegn	stegn
chaokat	chaokatchaokachaoki
gwaskennet	gwaskennet
Siriusaat	siriusaat
atrakourion	atrakour
Ten	ten
islounkus	islonkus
liprt	lipraat
divreac'ha	divrec'ha
splanndr	splannder
kourd	kourd
rizennandremmwel	rizenn
Bon	bon
tadkozargaou	Tadkozhargaou
peurgempennet	peurgempenn
goenvaat	gwevnaat
baroniah	baroniezh
Doc'h	doc'h
hungareg	hungareg
blankadurez	blankadurezh
wardrenv	wardrev
stageingoap	goap
spv	spev
obrouskon	brouskonenn
dihalan	dihala
Bh	b
karmelitezed	karmelitezed
gwezavank	avank
klufan	klufan
penfollet	pennfollet
lavionen	lavionenn
enemchaokat	chaokatchaokachaoki
apach	apach
dispont	dispont
Andonhandon	andon
Gwenved	gwenved
bernwarvern	bernwarvern
morfont	morfont
c'halloc'hat	galloc'hat
bepenamzer	amzer
melezouri	melezourimelezoura
awellforzh	awellforzh
arc'hezekmenez	marc'hmenez
bourret	bouret
Dourdiz	dorndis
gravia	gravia
eurc'hranvasdaoubenn	kravazhdaoubenn
eurweenbae	gwezbezv
z	'z
noellen	nouelenn
aziroufennas	diroufenna
adkemer	adkemer
gez	heugez
Varc'horre	warc'horre
lanfre	lanfre
lenn	lenn
disoudard	disoudard
poultrenna	poultrenna
distager	distager
adro	adro
breizad	breizhat
voterez	voterezh
c'hlebori	glebori
lestrchacher	sacher
veogal	beogal
eundorgosenn	torgosenn
arglufaned	klufan
marzouelleien	borzevelleg
eurgoukou	koukou
bridmouchet	bridmoucha
gwelliennet	gweliena
daletoc'h	dalet
dramailhet	tramailhattramailhi
firig	firig
zakridigez	sakridigezh
c'hoarzhdic'hoarzh	dic'hoarzh
demvreton	damvreton
sakrilaj	sakrilaj
diuntu	diuntu
sabren	sablenn
dourgn	dourgan
arumdarum	arummdarumm
terderann	trederenn
lutik	lutik
lestrtarzer	lestrtarzher
treindrezenn	trendrezenn
dijen	dijen
fardach	fardaj
hanterober	hanterober
Chalp	chalp
irinjez	irinjez
Marc'hsot	marc'hsot
nazizanale	dizanala
anavedigh	anavedigezh
trestou	trest
cander	kannder
Astell	astell
placqou	plak
Madedoue	madedoue
dijagrin	dichagrin
touneta	touneta
aruzbotez	aruzbotez
diarc'hennflipez	flipes
morsr	morser
gwazied	gwazhienn
karvraden	karvraden
moraill	morailh
dizornet	dizornadizornia
Kanitel	karitell
Mekanik	mekanik
vroennIndez	broenIndez
SperedSantl	SperedSantel
arc'hignalar	kignarar
Alajadoualajadao	alajado
distereden	disteredenn
dianvzour	diavaezour
ruilhdiruilh	diruilh
adgwelet	adwelout
peurgloza	peurgloza
tismant	dismantradismantridismantr
Rouejoumouilh	mouilh
tistrabouilha	distrabouilha
kran	kran
sourbedein	soulbedi
disorb	disorb
Studierien	studier
strak	strak
plaskriou	plaskr
sorodenn	sorodenn
bodad	bodad
pourlezennet	pourlezennet
arvaladen	maladenn
Mardoumen	mardoumen
arc'hartan	karrtan
forbann	forbann
azicouras	sikoursikouri
fuzuilherien	fuzuilher
labousednoz	labousnoz
didoenna	didoenna
dourta	tourtaltourta
akord	akort
toenn	toennvaot
distrellet	distrellet
Azerez	azerez
tauladur	taoladur
LezennStur	lezennstur
didok	didog
hatarelleu	katarello
Peurfaezet	peurfaezhi
disoudarda	disoudardadisoudardi
flammadeu	flammad
dilorc'husa	dilorc'hus
objektivelezh	objektivelezh
diveleg	diveleg
matagnouze	tagnouzaltagnouzattagnouzi
pounnereet	pounneraet
fardilhon	fardilhon
gamdroieu	kammdro
direlijion	direlijion
vanifesti	manifesti
ssadn	aesadenn
lorc'hi	lorc'halorc'hi
riad	euriad
butunchik	butunchik
skrilhwez	skrilhwez
diskosellein	diskoaselli
reipaved'	pavez
arc'holera	kolera
pelzog	pellzoik
dreabiou	drebiou
siberianiz	Siberianiz
spurmantein	spurmanti
setuaze	setu
kraoennvouch	kraoennvouch
frajipaner	frajipaner
auterveur	aoter
labourerporz	labourerporzh
ingochet	ingochet
'nimgasklat	kaskalat
flegenn	flegenn
C'hr	c'hri
Revorennou	revorenn
sentusous	sentus
kordennad	kordennad
pizeg	pizeg
dihuein	diweadiwei
faizanted	fesant
ravolt	ravolt
blewkoukou	blevkoukoug
kildroet	kildroet
logenn	loaegenn
bezin'pse	bezhinpese
dizudi	dizudi
gloanryen	gloanergwlaner
kalzenn	kalzenn
Jakez	Jakez
brochenn	brochenn
tioueledi	dioueledi
digoustianz	digoustias
digor	digor
pastellek	pastellek
tuda	tuda
atahinaj	atahinaj
andaolvoued	taolvoued
superstisionou	superstision
Chinoaz	chinoaz
Bilhongerh	bilhongerc'h
direlijiel	direlijiel
drezil	dresil
ar	klask
zilezadur	dilezadur
askournmorzed	askornmorzhed
diskoilh	diskoilh
biftek	biftek
defice	defis
kadrea	kadrea
jamezenn	jamezenn
melenek	melenek
Foultre	foultre
kragek	kragek
hartet	hartet
abafeit	abafaet
Degoch	degochi
mraktes	merak
drou	drouklamm
vlata	melata
daloni	taloni
gr	grez
reizskrivadurez	reizhskrivadurezh
ahanterguze	hanterguzha
Glizennfresq	glizhenngwlizhenn
taolstrap	strap
divelek	diveleg
loread	loread
giza	kizakizi
plasfoar	plasfoar
Blch	blech
dibenvestra	dibenveza
dins	dis
arvagvezina	bagvezhina
peurzu	peurzu
adreistholl	adreistholl
asperjezi	asperjezi
panermalestra	panermalestra
Riolennein	riolenni
seblant	seblant
didou	didou
pataforn	pataforn
diguh	diguzh
digompouez	digompouez
boulc'het	boulc'het
drebiou	drebiou
divlaz	divlaz
agilwidkaer	kilwed
dizoueet	dizouea
gwezsedra	gwezsedra
Logell	logell
marc'hptr	marc'hpaotr
spinahei	spinac'haspinac'hi
lezverc'h	lezverc'h
divilgin	divilgin
dichevat	diecheveat
drag	drag
tregorneu	trogorntrogorn
jatalkorn	chatalkorn
peguir	peogwir
abeadra	abeadra
pennadureziou	pennadurezh
darbodereh	darboderezh
adc'hoariet	adc'hoari
pikgoulennata	pikgoulennata
taneval	tanealtaneval
roustaden	roustadenn
geltad	geltad
volonjiriou	bolojeri
afreuze	freuzafreuziatfreuzi
ac'haoliek	ac'haolekac'haoliek
eroualh	rwalc'h
beuriac'haat	peuryac'haat
droukskoueriet	droukskoueria
listrikegin	lestrkegin
distagerien	distager
lorassenni	lovrasenni
c'hrignouzrez	grignouzerezh
akwit	ekuit
modesteteobet	modesti
gouihue	gouez
hulieukanevid	gwelekevnid
sekin	zoken
Ptrallizero	paotrallizhero
apresia	apresia
daoubik	daoubik
lejans	lejas
modest	modest
oufal	oufal
reihmat	reizh
guinvr	gwiver
eurvez	eurvezh
o	nodad
daeroSantLaoras	daerosantLaoras
merowingad	Merovingad
Anvoezet	havoueza
link	link
abepgiz	abepgiz
prad	kazhprad
mimpriz	mimpriz
Nedig	Nedig
bugelnoz	bugelnozbugulnoz
Rukunus	rukunus
ed	pelon
ramgoutur	ramgoutur
dialvaonet	dialvaoni
zidamfoltri	didamfoeltri
gouez	gouez
p	pe
chakerienoreor	chaokererevr
adaoldarzh	adaoltarzh
naroudnarabez	roud
karrbont	karrbont
argreverien	krever
alagad	alagad
nijerez	nijerez
arvester	arvester
mouched	mouched
saotret	saotret
avamen	avama
digourachet	digourajet
stoupr	stoupaer
taper	taper
arhoefbleo	koefblev
Diverr	diverr
anderzhienndifoeltr	difoeltr
askrabinaz	skrabinaskrabini
abiklammou	abiklammo
dallet	dallet
vanilhez	vanilhez
santelt	santelaat
lehoudorn	lec'hdorn
glazur	glazur
satordampet	satordampet
ehadtennas	adtenna
piched	piched
Fidamdommen	fidamdoumen
maenagatez	agatez
Galleksaout	galleg
anouedet	anouedet
vreoz	freoz
Gringailh	gringailh
ac'hruguill	kruguilha
tribledie	triblidie
Projuri	projuri
gwenaerez	gwenaerezh
chakellereh	chagellerezh
postkroug	postkroug
dichati	dichati
vikelaj	vikelajvikeliaj
io	surno
pennfollet	pennfollet
amzrieu	amzer
glazur	glazur
rivinet	rivinet
diharein	dic'hari
diforein	difoeri
lammkalon	lammkalon
kesar	kefarz
goanvez	goavezh
Irvinskoarngad	irvinskouarngad
bartikulier	partikulier
toullouselaou	toullselaou
stoubennek	stoubennek
pellgar	pellgar
Avieler	avieler
charinkadenn	charinkadenn
ovousluc'ha	mousluc'ha
barailla	parailha
garbeden	garbedenn
adaolearbilh	bilh
fausoni	faosoni
strakvourc'hiz	strakvourc'hiz
dichakota	dichakota
blejeres	blejerezh
prestour	prester
chalfaut	chafod
gazekdu	kazegdu
darempredaj	darempredaj
SantJakez	Jakez
hirreo	hirrev
GoueledKerne	KernevKerne
hrdein	herdi
hoalzispigneu	gwallzispign
porz	porzhhouarn
lijennet	lizennet
Palancgueu	palank
miserez	miserez
blokuz	blokuz
rangouli	rangouli
Kouignaour	kouignaouaer
diabegus	diabegus
Tourked	tourked
cousqedenn	kouskedenn
angouleg	angoulek
Geologiezh	geologiezh
zivelc'houeda	divelc'hwedadivelc'hwedi
salad	salead
reveulzi	reveulzi
mik	mik
boukin	boukin
divuzel	divuzell
distoket	distokadistoki
dichoselli	dichaoseria
Sako	sako
peurlaret	peurlaerezh
warsklij	warstlej
sebezus	sebezus
peuzkrev	peuzkrev
mol	moullboto
Kranksabl	kranksabl
fasafas	fashafas
halegmor	halegmor
dimez	dimez
vailhurou	mailhur
compagnunez	kompagnunezh
framasonek	framasonek
anamizelao	izelaat
grilhedsabl	grilhsabl
paotrarchas	paotrarchas
arglochenn	klochenn
zivelgri	divergladivergli
karder	kaerder
aziwargichen	aziwargichen
grabousou	kraboso
distoka	distokadistoki
distrouillh	distrouilh
boulverz	boulvers
taulguern	taolgwenan
yac'hhadibistik	dibistig
roulouerat	roulouerat
kalbennet	kalbennet
gwalskei	gwallskei
tontonbesk	tontonbesk
kiza	kizakizi
lavarenn	lavarenn
chipot	chipot
diodez	diodez
chipoterez	chipoterezh
amoniak	amoniak
BroJudee	Jude
bidonnek	bidonek
lagadet	lagadet
Peurglozet	peurglozet
stoubennek	stoubennek
peziouc'hoari	pezhc'hoari
Eurvaraz	barazh
agreizholl	agreizholl
habillod	kabilhod
vleukata	bleukata
avire	viri
dalput	dallput
Ambab	ambab
fronj	fraojal
dic'hoarzh	dic'hoarzh
mestrkeginer	mestrkeginer
barabonimal	bonimal
goaffryen	goafer
renevezi	renevezi
divane	divane
barr	barrti
delour	dleour
urgailhenn	kailhenn
Leksional	leksional
droukizili	drougizili
guerh	gwerc'h
'TraouDoue	traoDoue
heunan	eunan
peurlidan	peurlida
Dornlabourrez	dornlabourerezh
harpa	harpaharpi
oranjez	gwezorajez
skanteged	skanteg
sentus	sentus
nezidavarnket	didavarni
hengernevek	hengernevek
zabranek	sablennek
engroes	engroez
nedintasket	tintaltinta
kiza	kizakizi
pusuniet	pusuniet
andersienvelen	terzhiennvelen
del	deil
lopagn	lopagn
kleregvor	kleregvor
dismuniet	dismuniet
hollrac'h	hollrazh
perrest	peurrest
brumenet	brumennet
Neziskodegeket	diskodegi
kafr	kafr
klyadou	keliad
fric'hwesa	fric'hwesha
podte	podte
pareet	pareet
dilabouradeg	dilabouradeg
eubiet	eubiet
salad	salead
dic'hlac'har	dic'hlac'har
dibunereh	dibunerezh
aguilhe	kuilhakuilhi
dispount	dispont
Louskon	louskon
krankbigornenn	bigornenn
Abian	bian
enemzisujas	disuja
hadzerret	adserret
Rannvroour	rannvroour
kabidoch	kabidoch
Justin	justin
ingoulek	ingoulek
pilerionbeg	pilbeg
Amzeri	amzeri
brihnoz	brizhnoz
rantikou	rantiko
bilhejivot	bilhedvot
enassans	asas
Amc'hallus	amc'hallus
avalbouzenne	balbouzenni
Lena	Lena
Bali	bali
lestrugel	lustrugenn
flemmek	flemmek
Urvlas	blaz
banbochour	bambocher
druezusted	truezusted
izelaat	izelaat
ivlneg	eoulennek
Everans	everias
mintrailhi	mindrailhi
Chaouswarnout	chaous
meneget	menegi
millr	miller
paluderien	paluder
flep	flap
taneval	tanealtaneval
maniog	maniok
Ergomers	komers
advota	advota
bardelldro	bardelldro
dluzus	dluzhus
dadra	dadra
peuzpell	peuzpell
eurc'halvadeg	galvadeg
likenn	likenn
didougnet	didogna
warvetenebeut	warvetenebeut
dihoddivod	diod
ruilhdiruilh	ruilhdiruilh
stalioubara	stalvara
fagoder	fagoder
stank	stank
diamezeka	diamezek
Eundarinenn	tarinenn
Kembreat	kembreat
Breinchan	chan
skeudennet	skeudennet
paotrarchas	paotrarchas
komunistiez	komunistiezh
touch	touch
alac'hkyklanv	alazhki(klav)
skolpenn	skolpenn
emaoutkoll	koll
bleudryen	bleuder
diskuilh	diskuilha
lapineta	lapineta
adreuzjou	adreuzjouadreuzo
Azurryen	asurer
toennet	toennet
dic'halos	dic'halos
bleizlern	bleizlouarn
dizwalc'het	disgwalc'het
zidagein	didaga
frigarlot	garlot
vanneata	banneata
monedone	monedone
dilaosk	dilaosk
gomanderez	komanderezh
difoutre	difoutredifoultre
hanobed	anvbed
barti	parti
seblant	seblant
Agomz	agomz
arGloria	gloria
klikklok	klikklok
dasad	tasad
koataet	koataet
argomzplen	komzplaen
eurvezhiadenno	eurvezhiadenno
adorimel	adorimell
fouereh	foeverezh
skilfadenn	skilfadenn
drezil	dresil
dilagad	dilagad
Manous	mannouz
Libidrant	libidrant
storlok	storlok
dialet	diahelet
etivarvin	divervel
Pleboul	Pleboull
digouezet	digouezha
mafelleganin	fellelfelloutfallout
divrezonega	divrezhonega
arzour	arzour
truket	truka
zantelezi	santelezhasantelezhi
jastra	jastra
Adaolkrenn	adaolkrenn
digor	digor
ankoua	ankoua
dibohonein	diboc'honi
redadeg	redadeg
kafourchein	kafourchi
koumoulus	koumoulus
felerinenno	pelerinenn
dembareet	dambarea
veglip	beglip
Seki	sekie
meginat	meginat
vouilhaza	bouilhaza
c'hoantastik	c'hoantastikc'hoantasik
ervalivenn	bali
Gwerec'hig	gwerec'hig
lnet	lennet
rustein	rusti
arbrosesion	prosesion
breou	brec'hkarr
klemmerienergoudor	goudor
androvan	trovan
Kilhogi	kilhogi
Eurc'harleneg	garleneg
gwiraoui	gwiraoui
luhek	luc'hek
stalen	stalenn
grewi	grewi
kolguelag	koll
Kouzimati	kouzimati
Stourmerien	stourmer
moullecg	moulleg
disrann	disrannadisrann
emgros	emgroz
morgizier	morgazh
alvanet	alvaonet
Dilaoienn	dilavenndilavienn
errestel	errestel
diginkl	diginkl
Tabok	tabok
deilad	teilad
c'hustumanchou	kustumanto
divalotaj	divalavtaj
abln	plaen
dizeri	dizeri
dibotailh	dibotailh
touneta	touneta
azic'haloupaz	dec'haloupat
damc'houez	damouez
istrujein	istruji
aziskrankas	diskranka
postourbro	posterbro
zigourachi	digouraji
diardo	diardo
damofisiel	damofisiel
Flega	flega
labourkorf	labourkorf
modpevod	modpevod
astlibike	stlibika
fran	fran
arvroadelerien	broadeler
didaulein	didaoliadidaoli
ganttrugar	trugar
Icht	ichtich'ta
Mardandomen	mardandomenn
azispleit	displedi
Dihibillein	diibilia
grateit	grataet
hadkoachet	adkoacha
tennaj	tennaj
groenlandek	greunlandek
ahantr	ahanter
arstru	rstrew
lostad	lostad
arabek	arabek
daoubenni	daoubenni
daoubennet	daoubenni
spurjan	spurjaspurji
chuerje	chuerjal
bouteilhr	boutailher
boustouf	boustouv
stardhastard	starthastart
peurbeoc'h	peurbeoc'h
drod	droaddroed
krustoc'h	krustoc'h
mnKoadri	maenKoadri
meurvad	moarvat
Fed'amzoupen	fedamzoupenn
diyalc'ha	diyalc'ha
ruzererevr	ruzererevr
zigorvadein	digorfadi
sklis	glis
neuhan	nevezhav
neieu	nevez
lizik	lizik
argasenn	kasenn
soniri	soniri
fachemant	fachamant
zaonen	saonenn
adrohatro	adrohatro
naontekved	naontekvet
pevarlamm	pevarlamm
agroazigellgant	kroazigell
kozigellou	kozhigell
peurzouezet	peursouezhet
cheuchou	cheucho
zors	sorsdour
tisirita	disirita
bronderehbrodereh	broderezh
arheskobet	arc'heskobi
erviridig	birvidig
eurhuignzegal	kouignsegal
stranell	stranell
flaboterezh	flaboterezh
talari	talari
mas	maiz
disans	disas
deliou	deliaouenn
Basta	basta
plgour	pleger
diandon	diandon
anevalmut	mut
divegon	divegon
Gwazienn	gwazhienn
fohein	fouezhi
zed	aezet
Gwall	gwall
paadeu	pavad
skod	skod
viskoulruz	beskoulruz
hoehiad	gwazhienn
dregichen	dregichen
gortaden	gortadenn
samoura	samouray
begad	begad
magnetek	magnetek
sarf	sarf
vevvuhezegezh	bevbuhezegezh
Veronika	Veronika
vuzugennat	buzhugennabuzhugennatbuzhugenni
toullerarrevaro	touller
myrrwin	mirwin
distrapennet	distrapenna
kellid	kellid
diskouezadek	diskouezadeg
kastellperoked	kastellperoked
didr	didaer
fentadennou	fentadenn
kernielet	kerniellet
hersalhersein	hersalhersahersi
koc'havaloudouar	koc'h
karkailh	karkailhenn
begad	begad
Pitronig	pitronig
rusian	rusian
gwenid	gwenid
avalpato	pato
Gwardma	gward
kelientsetse	kelientsetse
Duod	Duaod
truhdohoh	truez
dic'hout	dic'hout
sklabuz	stlabussklabus
chouannaj	chouanaj
daouugent	daouugent
bouilha	bouilhabouilhi
Kembread	Kembread
stragnadeu	streiniad
gwelt	gwelt
norvejeg	norvejeg
gltouseg	glav
mikadur	migadur
chingailha	chingailha
tsitsitsi	tsitsitsi
koko	koko
rampikulot	rampikulot
toket	toget
Fidambie	fidambie
Leurenn	leurenn
Babarig	babarig
flamin	flammin
mesneabuzambket	abuziabuz
Skouzachi	skouzachi
eurgauzeaden	kaozeadenn
arC'heumraeg	kembraeg
urveskailhez	meskailhez
aveet	aveiaven
eskoptiaj	eskoptiaj
marebelfec'h	rebellarebelli
Herri	Herri
gaerderiou	kaerder
arguchurell	kuchurell
aadvinnigo	advinniga
semplet	semplet
chalboterien	chalboter
Gwill	Gwilh
vagpesketa	bagpesketa
arc'hentlaez	kentlaezh
z	aez
aljemant	alejamant
Katarin	Katarin
aotervraz	aoter
ismegou	ismego
klogoret	klogoret
diharak	diharak
keitet	keitet
bageer	bageer
beurskolia	peurskolia
regarherz	regarzherez
lizidant	lizidant
botouchoukenn	botezchoukenn
meret	meret
divroerien	divroer
julodezed	julodez
enemzimerdi	dimerdi
gurunaj	kurunaj
adreuzskoaz	adreuzskoaz
karamel	karamel
endevoutfache	fach
arhour	arc'her
berliten	berlitenn
mekanika	mekanika
kampou	kampou
krankaval	krankaval
Bigidreouel	bagdreouel
gallegacher	gallegajer
tranter	treanter
ofereneured	oferenneured
moka	moka
lakepoterez	lakepoderezh
andreuz	dreuz
didorridigez	didorridigezh
nabervougoket	peurvouga
kalabl	kalabloaz
asmern	azverenn
arrizenvoger	rizennvoger
valvennikven	malvennwenn
ingennour	ingennour
chatilhoned	standilhon
ion	bevoniour
divrezonega	divrezhonega
tiegezchennou	tiegezhienno
dilenner	dilenner
Kaskalatkaskarat	kaskalat
skaoduet	skaoduet
dignol	tignol
laeronvor	laermor
cours	koulz
abeurzisplegas	peurzisplega
diavz	diavaez
bahaden	bazhadenn
Rirc'h	rirc'h
siseurt	siseurt
hurupaill	urupailh
Dampret'vo	dampret
diavzet	diavaezi
bevarenn	pevarenn
desfailh	desfailh
adreuzkaer	adreuzkaer
vroa	broabroiabroi
houstet	houstet
skign	skign
bioulart	bioulart
soufrek	soufrek
ion	voter
chourgana	sourgana
sitrouilhezen	sitrouilhezenn
raou	rav
roustad	roustad
perager	perager
diboell	diboell
pipial	pipial
aveliokenwerzh	avelgenwerzh
relz	relez
setuperak	setu
poullkanna	poullkanna
revel	revel
sorohellet	soroc'hellet
liboustenn	liboustenn
tregondad	tregontad
arc'hoenvdourek	koevdourek
dizouill	disouilh
muiouzmui	muiouzhmui
diaheurtein	diaheurti
dizeuni	tizani
heilhen	heilhen
maruail	marvailh
plo	plomadur
lherion	dibilher
d'hent	hent
avilvern	avilvern
didu	didu
bojardet	boskardet
waga	gwaga
arvouk	arvouk
allik	all
skarp	skarp
zresaat	dresaat
azibouez	azibouez
wardaston	wardaston
katrad	katerat
peinsellet	peseliet
atanti	atanti
saveteat	saveteet
palankou	palank
sieudu	saezu
vitaouik	mitaouik
esouz	esouz
argornaoueg	kornaoueg
futed	futet
heginanerien	eginaner
fleuranhav	fleuranhav
foazadennou	poazhadenn
arvoullerez	moullerezh
Seihtu	tu
bourdilhon	berdilhon
brugerezedPoullan	brugerez
stummbeva	stummbeva
eien	born
Peurvad	peurvad
didalvezded	didalvezded
spont	spont
Chivous	chivous
vregach	vregaj
savas	savas
avaman	avama
ajantmear	adjantmaer
revorenn	revorenn
eneurskarmotal	skarmotal
tikou	tikouez
delivrans	dilivras
krasoriou	krasorio
klodad	klodad
tiekou	tieko
laveant	laveant
adpourchas	adpourchas
distan	distan
dijen	dijen
chakerezpatatez	chaoker
harpan	harpaharpi
Matich	matich
deliaen	deliaouenn
nijerez	nijerez
blein	blein
Fromveur	Fromveur
Bourjin	bourjin
bismigad	pismigapismigat
jaritelleion	jaritelleg
begecho	begechenn
gwregkle	gwregkleiz
leur	leurbont
furmryen	furmer
rodherr	rodherr
tourtan	tourtan
kronchet	grojet
ranellerez	ranellerezh
zivreiza	divreizha
zreujou	treuzo
sevenadur	sevenadur
avaleruzaz	maleruzi
fouaj	foevaj
babori	pabori
bistolodi	pistolodi
livonj	livoj
filozofiez	filozofiezh
ripe	ripa
gwallon	gwallon
taboure	tabore
arvazchel	bazhchel
groahigdoar	gwrac'hdouar
trelatour	trelater
eurvourgleuenn	morgleuzenn
Kelo	kelokelav
Harpoun	harpon
balhed	balc'hed
loenedtenn	loentenn
beurdogaarstal	peurdoga
azibouez	azibouez
gorreen	korreenn
remochadeu	remortad
togskoev	skoev
prey	prei
aberc'henn	perc'hennaperc'henni
dic'hrasia	dic'hrasia
direun	direun
Aermor	naervor
ma	er
poaztan	poazhtan
plaouf	plaouf
diboagn	diboania
leunbourr	leunbourr
mougenet	mougennet
ziskrapellat	diskrapellatdiskrabellat
deu	deuv
chek	leunchek
haderez	haderez
adreuzhagahed	adreuzhagahed
voret	eoreteoriet
kenaoz	kenaoz
Nogig	nogig
erhuiniegerion	gwiniegour
stummbeva	stummbeva
'Bennarfin	abennarfin
ion	adfekioner
Distoka	distokadistoki
bibich	bibich
Roc'honell	roc'honell
chas	chas
gieza	kieza
rannyezel	rannyezhel
pismintia	pismigapismigat
tiglanchedi	diglachedi
fluan	flua
bles	bles
melhueden	melc'hwedklorek
distoueindistoein	disteidistoi
Strinkerez	strinkerezdourstrinkerezandour
arziot	arziot
Guigour	gwigour
raou	rav
aerlistri	aerlestr
trodroio	trodroio
ueniheg	gwinizheg
enemdna	tana
Youenn	Youenn
gouarnour	gouarner
ehoros	horosi
Kntol	kantol
baramouchen	baramouchenn
menon	menon
flandrezek	flandrezek
Tourtal	tourtaltourta
direoriet	direvretdirevriet
madelezus	madelezhus
agrogpa	agrogpav
arbrijez	arbrijez
drouizezed	drouizez
pilpazat	pilpazat
diblijus	diblijus
mogerioudifenn	mogerdifenn
asiouaze	siwazhi
divenn	divenn
divent	divent
enebarmeer	enebarmeer
treuzi	treuzitreuza
ervanbocherion	bambocher
ju	ju
odivi	odivi
aparanseu	aparas
Damandiemeigne	damandiemeigne
Arc'hlenvedpenteo	penntev
Koarenni	koarenni
c'houezarfoec'h	foec'h
arvourgleuenn	morgleuzenn
digleuz	digleuz
gwardadrev	gwardadrev
voullerez	moullerezh
divraza	divrazadivrazi
enemrebardina	rebardina
lorgn	lorgn
dornred	dornred
warbennneuze	warbennneuze
desert	dezert
fonen	foennenn
dilivrans	dilivras
bouskennet	bouskenni
lardik	lardik
aambus	abuziabuz
broderez	broderezh
ion	kreioner
azindanannoz	azindannozazindanannoz
dereapl	dereapl
Tivet	tevet
dismantrus	dismantrus
prokulormeur	prokulermeur
avgad	begad
peurzic'haouet	peurzic'haoui
tonndero	tontderv
Jos	Jos
Nezigrogne	digrogna
eblzheblz	ebeulez
awelforz	awellforzh
tadpriol	priol
diveunekat	diveunekaat
enemimoli	imoli
bilh	bilh
rafia	rafia
braobras	bravbras
goulined	koulin
pres	pres
peurlaza	peurlazha
Bruskou	brusk
poellus	poellus
antudiavaez	diavaez
tirampa	dirampa
hadeski	addeski
zouarenn	douarenn
treaz	treaz
Hanes	hanez
reverez	reverezh
edok	edek
savas	savas
ardivink	ardivink
Brall	brall
gros	gros
organisa	organiza
bransellet	brasellet
gl	glav
avanturaden	avanturadenn
lagoutchistr	lagoutsistr
brein	brein
begad	begad
Urbam	bam
kreizenner	kreizenner
Diswenna	disgwenna
killourzein	kilhourzi
dic'hrozet	dic'hrozet
krachmein	krachmein
meskadenn	meskadenn
Adkanan	adkana
mindraill	mindrailh
enemskora	skora
enemskuiza	skuizha
chargwinhoc'h	chargwinhoc'h
bihoutig	bihoutik
Fed'amdoulle	fedamdoulle
sioupleo	sioupleo
damvaro	damvarv
morbik	morbig
petailh	petailh
razeskern	razeskern
Didroiellet	didroiellat
arvouzellendall	bouzellenndall
divinadellou	divinadell
brogarerion	brogarour
motet	motet
lostreugen	lustrugenn
stangkannan	stankkanna
koadkelvez	koadkelvez
gonachtr	gonaster
bir	bir
hadprena	adprena
spourounet	spouronet
devhadeu	diwezhad
Niedrohiell	troc'hiella
parlako	palank
Hujaotereh	hujaoterezh
Hirbadout	hirbadout
freget	freget
divrezonega	divrezhonega
liselskloayerez	stloagerez
salmadenni	salmadenni
avei	aveiaven
platinennou	platinenn
evelkent	evelkentevelkent
dominoenn	dominoenn
adorimel	adorimell
bejinpse	bezhinpese
goulosk	goulosk
dalhiadeh	dalc'hiadezh
malan	mall
zic'houedi	dic'hwedi
nann	nann
keijhameij	kejhamesk
dournis	tournis
sankou	sanko
dizurchou	dizurzh
mestrezenn	mestrezenn
enemankounac'hat	ankounac'haat
difuriet	difuriet
Terennet	terenni
urgraoenngokoz	kraokokoz
Friantellat	friantellat
neovara	nevvara
dizallet	dizalla
pastk	pastek
pourlet	pourlet
mandoserezet	mandoserez
meanikruilh	ruilh
Kanhadiskan	kanhadiskan
fontetgandarvz	fontafonti
ravalenk	ravalink
anderchenscarlatinn	terzhiennskarlatin
lavrez	lavrez
arFerlez	Ferlez
direlijionidigezh	direlijionidigezh
gwirinal	gwirinal
d'	bam
ildreh	ilgrec'hildrec'h
adreuzhagahed	adreuzhagahed
awirike	gwirikalgwirikat
marmouzerez	marmouzerezh
bilost	belost
poloniad	poloniat
Stigenn	stigenn
pezavare	pezhavarepezavare
dac'hlochat	glochat
lankoud	lankoud
lardor	lardouer
peluz	peluz
zavadennou	savadenn
dambrzerion	dambrezer
Boutrrterieu	bounter
daletoc'h	dalet
mnpouez	maenpouez
varbilh	barbilh
skarz	skarz
krizer	krizer
dilatin	dilatin
ali	ali
laterell	laterell
kambrwele	kambrwele
pirrig	pirrig
Arabed	Arab
askampeubras	askampo
krabanaouekoc'h	krabanaouek
Braeat	braeabraealbraeatbraeiatbraei
jardigennat	jardigennat
hoarigaerat	c'hoarigaerat
sorodenn	sorodenn
didrec'h	didrec'h
linn	linn
spern'mor	spernmor
wardremez	wardremez
skuizet	skuizha
plak	plak
arvoudennbesked	moudennbesked
didanet	didanet
raskenn	rasklenn
zic'hlapezia	dic'hlapezia
sorodenn	sorodenn
ratikou	ratiko
skuignen	skouignenn
gluchet	kluchet
sonerez	sonerezh
tulodet	tulotet
meskadenn	meskadenn
siouladen	siouladenn
BegmaZok	begmazog
las	las
espernel	espernel
fallgalonus	fallgalonus
gevella	kevella
Kognet	kognet
barreziadou	parreziad
branelloutreid	branelldreid
Farsite	farsite
jaogell	chaogell
hjereh	hejerezh
tipedi	tipedi
ganch	gas
anwazi	anoazhi
jalgod	jalgod
tiskorda	diskorda
multrret	muntreri
jikoloden	chikolodenn
guirin	gwezirin
avgad	begad
mitonellet	mitonellet
tic'harza	dic'harzha
tennac'hwibez	c'hwibez
breinkot	brein
heuen	huanhue
delestaj	delestaj
agropad	krapad
goular	goular
klor	kloer
Eundarinenn	tarinenn
rezizen	rezizenn
kammichal	kammichal
Oanes	oanez
dic'hiozet	dic'hiozet
urc'hornruz	korn
kighafars	kighafarz
navitse	evitse
tir'net	tirennet
uidouar	vidouar
zifonder	difonnder
ofisiel	ofisiel
goazenzour	gwazhennzourgwazhiennzourgwazhienndour
Dibl	dibell
divazoulen	divazhoulenn
arul	arwele
balustr	balustr
trevez	drevez
sicourdezn	sikoursikouri
digenseurt	digenseurt
termajio	termaji
skinwelerez	skinwelerezh
kahieret	kaieret
simonieg	simonieg
dirabaz	dirabas
Kilheret	kilheri
farwel	farouell
inouet	enoeet
kluchet	kluchet
brunellereh	brunellerezh
avgad	avegad
kam	kamm
arpeurvuia	peurvuia
Dizoari	dizoari
maraonik	maraonik
akajou	akajou
niaambleudo	ambleudi
kemeret	krev
andouv	andouv
flourada	flourada
dizabolu	dizabolu
foenchen	poechenn
jeun	jeun
dizakr	disakr
egizall	egizall
hochellein	hoskellathoskelli
Faouter	faouter
dizoun	dizon
azindanzivin	azindanzivin
potarnet	potarni
luc'hachat	luc'hajat
krankedsilio	kranksiliokranksilienn
ribotadenn	ribotadennribodadenn
leinzi	leinzi
Skelbia	skerbia
skuiza	skuizha
pegoulz	pegoulz
maredavare	maredavare
gweztilh	gweztilh
urhandad	kantad
diharzadur	dic'harzhadur
adizhagadag	adizhhagadag
divlein	divlein
bougar	bougre
valeruzi	maleruzi
vazegin	bazegabazegi
Treuzcomz	treuzkomz
bren	brein
meiz	meizmez
feizleun	feizleun
Amzerzobet	amzer
dihouour	dihueer
to	to
laoukrapitous	laoukrapitous
Japon	Japon
Gour	gourlivant
agreiz	agreiz
hostizez	ostizez
ruzenn	ruzennnoz
prest	prest
dic'hiz	dic'hiz
astrollad	astrollad
pismiget	pismigapismigat
divoulsa	divoursadivoursi
roudou	roud
cincqlryen	sinkler
Gousiadenn	gouzeriadenn
adrouc'h	adroc'h
nivet	nivet
diskuizhadus	diskuizhadus
daeroSantLaoras	Laoras
chalfaud	chafod
azedera	sederaat
peuryac'h	peuryac'h
azigant	diganta
karg	karg
frouezhbara	frouezhbara
adro	adro
pounnerglevet	pounnergleved
eunan	eunan
enemziboania	diboaniadiboanii
Satordallikhapluskdero	satordallik
trech	trec'h
diglened	diglevedi
vojellat	mojellimojellat
peurganet	peurgana
hadpokat	adpokat
plomadek	plomadeg
biet	bezia
mistrizi	mestrezenn
arvulez	mulez
dismantra	dismantradismantridismantr
avamen	avama
aentize	entiza
diswinta	disgwinta
rodlas	rodlas
azistumme	distumma
setuma	setu
porzhiokenwerzh	porzhkenwerzh
Eurc'hantvedad	kantvedad
setuazo	setu
gwezpupli	gwezpupli
gweur	gweur
abeurgloz	peurgloza
mizou	miz
direolet	direolet
divreizekaet	divreizhekaat
eu	bir
gevnidek	kevnidek
dibrenn	dibrenn
peurfin	peurfin
aziarbremen	azirvrema
galfrezenn	galfrezenn
aveinaven	aveiaven
levr	levrdorn
lentet	lentet
diorbid	diorbid
bennigadenn	binnigadenn
skarvenn	skarvenndant
SantezAnnaPrad	SantezAnnaPrad
laezgwedenn	laezhgoedenn
agavez	agavezenn
Ahanemande	ac'halemaac'hanema
listrikegin	lestrkegin
lestrsplujer	lestrsplujer
bleokaz	blevkazh
ziuerhzereh	diwerc'hezerezh
wazhiedgros	gwazhiennc'hros
goustelour	klaoustreer
urloskourgoleu	loskergoulo
ohroazed	kroazed
greunaval	greunaval
diempennet	diempennet
pikoupanez	pikopanez
anizet	anizet
Braeat	braeabraealbraeatbraeiatbraei
hentadeu	hentad
askiltr	askiltr
aezeta	aezet
gourset	goursezet
feuraer	feuraer
everz	hewerzh
trantigellat	trantigellat
iferni	iferni
kementaitik	itik
porpagn	porpagn
avelbeh	belbec'h
rederienvor	redermor
disoagn	disogn
kiksaezon	saesonsaezon
II	dis
barz	barz
abellamzer	abellamzer
diskleugen	diskleugen
bokedigtroadebeul	bokedtroadebeul
matinehansein	dinec'hasaldinec'hasi
lusilin	lusilin
urvugulz	bugulez
narakennep	fivadenn
demziou	temzio
Urwernsamm	gwernsamm
linkou	linko
baraudadbarodad	baraodad
endramm	endramm
luziant	luziant
dukard	dukart
Ouf	ouf
istrimant	istrimant
modpevod	modpevod
libousliboust	liboust
falleganig	fallegan
eurpoainou	poan
ion	pistrioniour
kavanusoc'h	kavanus
lodennet	lodennet
ohollzerez	telennhollzerez
Strailhera	strailhera
Tadergeu	tadargaouargevier
biekat	bevekaat
diialc'het	diyalc'ha
BroGerne	BroGernev
Drezichas	dichas
Broadel	broadel
baralli	paralli
LoeizVari	Loeiz
logoll	logell
koefiouplaen	koefplaen
Londrez	Londrez
Diembann	diembann
Toupin	toupin
Aes	aez
Kalonder	kalonder
blank	blank
dregichen	dregichen
gouez	gouez
eitrgethent	hent
ruzenn	ruzennveure
Dorifora	dorifora
amerikaneg	amerikaneg
daoubenni	daoubenni
aned	korrigan
Itiket	itiket
parapri	paraplu
bleuniet	bleuniet
eurgestennad	kestennad
profsi	profesi
tiziritan	dizirita
advoutenneu	advountenn
loskaet	laosket
Pezia	pezhia
satordero	derv
anglz	anglez
hunvredigez	hunvredigezh
lankout	lankoud
fiezennreal	fiezennreal
tasmant	tasmant
ezizall	dizalla
Obergnagn	gnagn
adkrouet	adkroui
ezetaat	aezetaat
fionour	fionour
diziaoul	diziaoul
struadig	strewadig
tic'harzha	dic'harzha
droukskoueriet	droukskoueriet
pasepia	pasepia
enhentse	hent
bourubourlu	bouruz
ablean	plaen
avidaddavidad	midad
jaret	jaret
saotr	saotr
Begchopin	begchopin
urvouzarenn	bouzarenn
Trepanein	trepanitrepana
asgenel	azgenel
gresat	gresaat
gomodite	komodite
deskard	deskard
razedenn	razhedenn
eundolbezennad	tolbezennad
ma	er
hoarierlatitrui	latitrui
streuveul	streuvell
Abuz	abuz
abeurvruzuno	peurvruzuna
lumirato	lumirato
chistrek	sistrek
laouenedigez	laouenidigezh
difardet	difarda
gwazoniezus	gwazoniezhus
bre	bre
biek	bevek
mantein	meanti
kofitet	kofiti
termer	termer
etelefonas	telefoni
jagen	jagenn
dibabou	dibabo
penseilet	peseliet
dinec'h	dinec'hi
avamen	avama
heskenvucher	heskennvucher
uz	uz
grougous	grougous
abuzet	abuziabuz
aigela	izelaat
drelec'hma	drelec'hma
streiniad	streiniad
alok	loka
canin	kanienn
peiselpensel	peisell
gwazoniezet	gwazoniezhet
divouqlei	divoukla
amiapted	amiaplded
lipet	lipet
gouleubr	goulobre
meskailhou	meskailho
folklorel	folklorel
klemmgan	klemmgan
Kignezek	kignezeg
sac'hrous	sac'hrous
adsamma	adsamma
santual	santual
influenza	influenza
fidorienn	fidorienn
avaloumir	mir
Urboblad	poblad
enemdisglac'hari	disglac'hari
dichouanti	dichouanti
stammiou	stammio
lazet	lazhet
pantier	panteer
Peurbrejet	peurbreda
Bregoniajkemener	bregoniaj
sularbleuniou	SulBleunioSularBleunio
enemenkrezi	enkrezi
hoarigaerat	c'hoarigaerat
damleun	damleun
mousklennet	mousklennet
falziget	falziget
eilskrid	eilskrid
androuzerien	trouzer
kulasen	kulasenn
