aabadennou	aabadenno
aaccord	aakord
aaccordvad	aakordvat
abad	abad
abad	abad
Abad	abad
abadma	abad
abadma	abad
abadm	abad
abaladeu	abalado
Abazeu	abazo
Ablamzer	abellamzer
ablamzer	abellamzer
Abellamzer	abellamzer
abellamzer	abellamzer
ablamzrqunt	abellamzer
abldebl	abelldabell
ablqunt	abellkent
ablquent	abellkent
ablquent	abellkent
ablquntma	abellkent
abennund'	abenneeunda
bninou	abenneno
abenfinandro	abennfinandro
abennnemeur	abennnemeur
bennnemeur	abennnemeur
abennneuze	abennneuze
Abennneuze	abennneuze
bebeild'erh	abepeild'arwezh
abebquis	abepgiz
bebmode	abepmod
abebmode	abepmod
aberzkaer	aberzhkaer
abehkaer	abezhkaer
abhcar	abezhkaer
abezkaer	abezhkaer
abiglammou	abiklammo
chomabla	ablas
echoumanablass	ablas
chomabla	ablas
Chomompablas	ablas
aboell	aboell
aboell	aboell
aboc	abok
ac'harden	ac'hardenn
ac'hizall	ac'hizall
agorgammou	ac'hourgammo
ahurlam	ac'hourlamm
ahurlam	ac'hourlamm
ahoustvad	ac'houstvat
ac'hourvez	ac'hourvez
ac'hruzuil	ac'hruzuilh
ac'hruzuil	ac'hruzuilh
adachadou	adachado
adachadou	adachado
adaill	adailh
adaill	adailh
adal	adal
adammadamm	adammdadamm
adaol	adaol
adaol	adaol
adaol	adaol
adaulsompren	adaolsourpren
adauleu	adaolo
adolpadeu	adolpad(ig)o
adorrpenn	adorrpenn
adosttedost	adostdadost
adoulladou	adoullado
adoullado	adoullado
Adravir	adrawir
adrefu	adrefu
adrspar	adreistpar
adrespar	adreistpar
adreushacahed	adreuzhagahed
adreuzhagahed	adreuzhagahed
adreushacahed	adreuzhagahed
adreushagahet	adreuzhagahed
adreuzhagahed	adreuzhagahed
adreuzhent	adreuzhent
ac'houezeadreuzvor	adreuzvor
adro	adro
Adro	adro
Adro	adro
adro	adro
adro	adro
adrochouk	adrochouk
adroetro	adroetro
adroetro	adroetro
adrocolier	adrogolier
adrhatr	adrohatro
adrocont	adrokont
Adroc'haskel	adroc'haskell
adropadeu	adropado
adruhegh	adruegezh
adudedu	adudadu
aenepkrenn	aenepkrenn
in	aeno
ainou	aeno
anou	aeno
aginou	aeno
azoaevezwar	aevezh
afars	afars
afa	afas
afassda	afas
afasd'	afas
Afadesn	afas
afdnoz	afednoz
afdnoz	afednoz
afdnoz	afednoz
afednoz	afednoz
afesquenneu	afeskenno
afechenneu	afeskenno
afinqes	afinkaezh
afond	afont
aforhadeu	aforc'hado
agakuadou	agakuado
agantchou	aganto
aganchou	aganto
aganchou	aganto
agarradeu	agarrado
aguetan	agenta
ageta	agenta
agetama	agenta
aguetanrah	agentarazh
aguetanrah	agentarazh
agetarah	agentarazh
Mervel	aglavwele
mervel	aglavwele
aglohad	agloc'had
gommancc	agomas
agommance	agomas
agommance	agomas
agomman	agomas
agommans	agomas
agreiz	agreiz
agreiz	agreiz
Agreis	agreiz
Agreiztout	agreiztout
agreistout	agreiztout
agripouh	agrizpoazh
agripoah	agrizpoazh
ahantr	ahanter
aanter	ahanter
ahantr	ahanter
aharp	aharp
aherzkaer	aharzkaer
hac'harzhasko	aharzhhagasko
ahendall	ahendall
ahineah	ahenozh
ahentadeu	ahentadahentado
aeskenkaer	aheskenn
ainiennou	ahinienno
ahiniennou	ahinienno
ahir	ahir
ahirded	ahirded
ahinihue	ahiziv
olviscoh	ahollviskoazh
aolviskoah	ahollviskoazh
ahordennou	ahordenno
ahoulen	ahoulenn
aisprid	aisprid
alair	alaer
alammkein	alammkein
alammploumm	alammplom
alammploum	alammplom
alamtourtarkaz	alammtourtargazh
aleizdorn	aleizhdorn
aleizkorzen	aleizhkorzenn
alivadou	alivado
anebeudouigou	anebeudoigo
anebeutanebeut	anebeutanebeut
anebeutzo	anebeutzo
anerzkaloun	anerzhkalon
aneuvad	aneuzvat
arac	arak
arac	arak
aredfors	aredforzh
reclom	areklom
arendaren	arendaren
arancad	arenkad
arengen	arenkenn
arenkenadou	arenkennado
aretourn	aretorn
aretourn	aretorn
aretorn	aretorn
aretorn	aretorn
aretorn	aretorn
aretorn	aretorn
aribl	aribl
aribl	aribl
vontaribgant	aribl
aribl	aribl
aribl	aribl
ariolen	ariolenn
ariolen	ariolenn
ariolennadeu	ariolennado
aruannad	aroevat
aruannad	aroevat
aroudennou	aroudenno
arumderum	arummdarumm
arumdarum	arummdarumm
arumdarum	arummdarumm
azerlagad	aserrlagad
askiant	askiant
askuer	askouer
erstalgostez	astalgostez
astedeu	asteudo
astdeu	asteudo
astoccroc'hen	astokkroc'hen
astrabil	astrabilh
astrob	astrob
astrollou	astrollo
unt	auntu
ganthan	auntu
avah	avac'h
avac'h	avac'h
avandennad	avandennad
avandennadou	avandennado
avaredavare	avaredavare
avarr	avarr
avad	avat
avad	avat
avad	avat
avgad	avegad
avemor	avemor
avent	avent
aventgand	avent
Aviez	aviez
avihantra	avihantra
avillerou	aviliero
avilionou	aviliono
avitin	avintin
Avitin	avintin
aviziken	aviziken
aviziken	aviziken
avizikenn	aviziken
aviziken	aviziken
Avloaszo	avloazzo
avole	avole
avostad	avostad
vostad	avostad
avostadeu	avostado
avostadeu	avostado
vouchadou	avouchado
avozadou	avozado
Avozadou	avozado
avrhad	avrec'had
avrhad	avrec'had
avrhad	avrec'had
avrahad	avrec'had
avrehadeu	avrec'hado
avrahadeu	avrec'hado
avryadcar	avriadkaer
avriadkaer	avriadkaer
avriadkorf	avriadkorf
avriadou	avriado
avoalc'hkaloun	awalc'hkalon
awalc'hegalon	awalc'hkalon
awe	awe
avelkaer	awelkaer
vezimniavell	awell
awezannamzer	awezh
avirdoare	awirdoare
avirdoare	awirdoare
ac'hrac'hel	awrac'hell
ayoanq	ayaouank
ayouancq	ayaouank
aiouank	ayaouank
ayouancq	ayaouank
Ayouancflam	ayaouankflamm
azanvez	azanvez
azanvez	azanvez
azeuh	azevezh
aziabarh	aziabarzh
aziabarh	aziabarzh
aziabarh	aziabarzh
aziabarz	aziabarzh
aziabarz	aziabarzh
aziabarh	aziabarzh
aziabarz	aziabarzh
aziabarhd	aziabarzh
aziabellguelet	aziabellgweled
aziadost	aziadost
aziadr	aziadro
aziaoul	aziaoul
Aziarben	azirbenn
aziarben	azirbenn
Aziarben	azirbenn
zerhias	aziriaz
aziarskan	azirskav
aziarscan	azirskav
aziarvras	azirvras
azibrad	azibrad
azibrad	azibrad
azilerc'h	azilerc'h
azilerc'h	azilerc'h
azilerc'h	azilerc'h
azindanguz	azindanguzh
azindanguz	azindanguzh
azindantenn	azindantenn
azindanzivin	azindanzivin
azindanzivin	azindanzivin
aziribis	aziribis
azivarbouez	aziwarbouez
aziwardro	aziwardro
azivardro	aziwardro
azerhlu	aziwarlaez
aziwarskan	aziwarskav
azoarevad	azoarevat
azournad	azornad(o)
azornadeu	azornad(o)
adornado	azornad(o)
azuman	azuma
abadaouet	abadaouet
Abadorenn	abadorenn
abofet	abafet
Abafet	abafet
abaffet	abafet
abaffet	abafet
abardaesvez	abardaevezh
abadrves	abardaevezh
abardaveznoz	abardaevezhnoz
abardaveznoz	abardaevezhnoz
habiltet	abilded
habiltt	abilded
abiltd	abilded
abiltd	abilded
habilentez	abilentez
abilite	abilite
abostoler	abostoler
abostoler	abostoler
abostoler	abostoler
abostoler	abostoler
abriein	abrii
abriein	abrii
absint	absint
abus	abuz
nehretketabuz	abuz
abus	abuz
abusance	abuzas
abuset	abuziabuz
humabuset	abuziabuz
haddresset	addresa
atjand	adjantmaer
hadjunta	adjunta
hadkemer	adkemer
hadkoachet	adkoacha
hadkoanian	adkoania
adorerion	adorer
adorerion	adorer
adoreurien	adorer
adprena	adprena
hadrei	adrei
adret	adret
hatretorn	adretorn
ehadretorne	adretorn
hadretorn	adretorn
hadskoaia	adskoazia
hadtaolet	adteurel
Hadgwellaat	adwellaat
hadgwelet	adwelout
enemadwelat	adwelout
hadwelet	adwelout
hadgwelet	adwelout
letgardien	aelgardian
ren	aeren
aret	aeret
eaz	aez
em	aez
zans	aezas
aesance	aezas
zettoc'h	aezet
zet	aezet
ezetat	aezetaat
aezeteasd'ezhan	aezetaat
ezetamant	aezetamant
setamant	aezetamant
affermn	afeurmi
affiet	afiet
affiet	afiet
ahdet	ahedet
aeled	ahelet
acolit	akolit
accompagnunect	akompagnunekaat
accompagnunecaat	akompagnunekaat
accompagnunecat	akompagnunekaat
aconit	akonit
aaccord	akort
accouragein	akouraji
accouragein	akouraji
acouragein	akouraji
acours	akours
akoutri	akoutri
Aksiatet	aksiantet
alamanden	alamandenn
Alarc'h	alarc'h
alarc'h	alarc'h
Alc'houezet	alc'hwezet
alleiget	alejet
alert	alert
alertis	alertiz
alfin	alfin
ali	ali
haliou	ali
ali	ali
ali	ali
ali	ali
ali	ali
ali	ali
Varali	ali
dreali	ali
alia	aliaalii
Paalier	aliaalii
Alina	Alina
all	all
al	all
keitall	all
alouberien	alouber
alouberez	alouberezh
alouberez	alouberezh
alouberez	alouberezh
alcion	alsion
alueten	aluetenn
aluzenna	aluzena
alvaon	alvaon
amandez	amandez
ambarassus	ambarasus
ambarquemantt	ambarkamant
Ambon	Ambon
ambraset	ambrazet
Ambros	Ambroaz
ambulant	ambulant
amnoh	amen
amnoh	amen
anfittre	amfiteatr
amgristen	amgristen
amguzet	amguzhet
edamizion	ami
amid	ami
ami	ami
amiablemant	amiaplamant
amoniac	amoniak
amhouyance	amouizias
impar	ampar
ampar	ampar
impar	ampar
impar	ampar
impar	ampar
enemamparaat	amparaat
amparval	amparfal
imparfall	amparfal
amparfall	amparfal
imparfal	amparfal
apeich	ampech
ampchet	ampechet
ampir	ampir
ampouezoun	ampoezon
amposoun	ampoezon
ampouisonour	ampoezoner
ampoesonnerien	ampoezoner
ampoesounerez	ampoezonerezh
ampouezounerez	ampoezonerezh
ampouezounet	ampoezonet
amportemant	amportamant
Hamsentus	amsentus
amur	amur
enemamuser	amuzi
amzer	amzer
amzersoudard	amzer
amzer	amzer
arBevareAmzer	amzer
amzerdiveza	amzer
bepeunamzer	amzer
bepenamzer	amzer
bepanamzer	amzer
bepanamzer	amzer
bepanamzer	amzer
amzerzobet	amzer
kozamzer	amzer
hedanollamzer	amzer
abepamser	amzer
Abepamzer	amzer
abaoepellamzer	amzer
abaouekeitamzer	amzer
urveachicanamzer	amzer
eurveachanamzer	amzer
eurvechennamzer	amzer
amzergers	amzergers
amzernehu	amzernevez
amzret	amzeri
amzevosion	amzevosion
amzevosion	amzevosion
amzevod	amzevot
amzigor	amzigor
hanunan	anunan
hanunan	anunan
anunan	anunan
annunan	anunan
alanaddiveza	analad
anaoudeien	anaoudeg
anaoudeien	anaoudeg
anaoudeg	anaoudeg
anaoudeg	anaoudeg
Anaoudek	anaoudeg
Anaoudecmad	anaoudekmat
Anat	anat
veanre	anat
hainad	anat
anatdioc'h	anat
oaanat	anat
anat	anat
kuzet	anat
anat	anat
Hanaedigehvad	anavedigezh
ehanavi	anavezoutanavoutanaout
anaout	anavezoutanavoutanaout
enemhanavezout	anavezoutanavoutanaout
enemanaout	anavezoutanavoutanaout
io	andon
andon	andon
hadon	andon
andon	andon
anemis	anemiz
anemisd	anemiz
anemised	anemiz
anemised	anemiz
anemisd	anemiz
neval	aneval
afa	afa
anfaziuz	anfazius
anfin	afin
anfin	afin
anfin	afin
anfin	afin
Anfin	afin
Anfin	afin
Eanflam	aflamma
angannet	angann
angls	anglez
Anigez	anigez
anjelik	ajelik
Anjina	ajina
Ankinust	ankeniusankenus
ankeniuz	ankeniusankenus
ankoua	ankoua
neankouefez	ankouaat
Neankounac'haimpket	ankounac'haat
ankounac'haat	ankounac'haat
ankounac'haat	ankounac'haat
ankounac'had	ankounac'haat
annamiz	Annamad
annamiz	Annamad
annamad	annamat
annamad	annamat
anneuegueah	anneuegezh
anwazet	anoazhet
anrejistramant	arejistramant
anans	asas
asas	asas
eanseign	asegn
anseignement	asegnamant
ansouhet	ansouezhet
ansouhettoh	ansouezhet
Antifonennou	antifonenn
antiphonenn	antifonenn
aantonas	antoni
aantonaz	antoni
Hanokaer	anvkaer
amzavet	anzavet
aubaden	aobadenn
Audren	Aodren
Autr	aoter
sakramantanaoter	aoter
lienenaoter	aoter
aotervraz	aoter
Aotervraz	aoter
leinter	aoter
autor	aotor
autresi	aotrezi
aouelet	aouelet
aoulaj	aoulaj
Aouredal	aouredal
aourfredour	aourfredour
appalaterez	apalaterezh
apparance	aparas
poptra'niapart	apart
apartne	aparteni
appel	apell
Apostat	apostat
apoeilhou	apoueilh
apreste	aprest
arskan	rskav
arstru	rstrew
arvoulge	rvoulj
arvoulj	rvoulj
erhoalh	rwalc'h
arhoalh	rwalc'h
erhoalhma	rwalc'h
arabet	Arab
arabet	Arab
Arab	Arab
Arabed	Arab
arabet	Arab
Arab	arab
ahndaral	arall
erral	arall
ral	arall
arauqueit	araokaet
arc'hbreuriez	arc'hbreuriezh
Arc'hbreuriez	arc'hbreuriezh
arc'hbreuriez	arc'hbreuriezh
arc'hdiakr	arc'hdiakr
arc'heskopti	arc'heskopti
arc'houre	arc'houere
arrestance	arestas
arrestance	arestas
arrestet	arestet
arahet	areuzhet
argadennou	argadenn
argaden	argadenn
argoadiz	argoadad
hergui	arguzi
arhent	arhent
aridennet	aridennet
arko	arko
arlicoed	arlikon
armenian	armenian
arneuoc	arnevek
arneuog	arnevek
o	arnod
arzd	arsot
artr	arter
varartiklarmaro	artikl
artisanpleg	artizanpleg
artisanpleg	artizanpleg
artizanein	artizani
aarvarfe	arvari
Harvari	arvari
Nearvarket	arvari
divarvrec'h	arvrec'h
Arouezet	arwezet
ardu	arzu
Ascension	Asasion
cess	ases
assied	asiedasiet
ascana	askana
ascant	askant
Azkavetoun	askavet
ascaout	askavout
ec'haskavas	askavout
ec'haskavaz	askavout
ec'hascontas	askonta
ascre	askre
en	askre
ascre	askre
aslavar	aslavaroutaslavaret
assolet	asoli
aspaden	aspadenn
esperjein	asperjaasperji
esperjereah	asperjerezh
oasperjezasperjuz	asperjezennasperjuzenn
asplega	asplega
asprenadurez	asprenadurezh
azprena	asprena
asprena	asprena
aaspreno	asprena
asprena	asprena
asav	assav
Aztaul	astaol
aztaulyou	astaol
Astaol	astaol
kikastenn	astenn
astenngouzoug	astenngouzoug
astennet	astennet
astenned	astennet
astennet	astennet
astommet	astommet
assurentez	asurentez
asuretin	asureti
attacion	atasion
atil	atil
atil	atil
Parkatil	atil
attrapet	atrapet
avalouoranjez	avalorajez
avaloustoup	avalstoub
avaman	avama
avamen	avama
avamen	avama
avamen	avama
Avaman	avama
Avamende	avama
avantachi	avantaji
n'avanturis	avanturi
avanturein	avanturi
Enemavanturi	avanturi
avar	avar
avad	avat
Ave	ave
avan	aveiaven
aveet	aveiaven
avieler	avieler
avieler	avieler
aviet	aviet
Avoultrer	avoultreravoultrier
Avoultrryen	avoultreravoultrier
aoultrierez	avoultrerezavoultrierez
avoultri	avoultri
avrhussan	avrec'hus
avrhus	avrec'hus
Ayol	ayol
azal	azal
asdalc'het	azderc'hel
asdemezi	azdimezi
azennicgueu	azenig
azennig	azenig
Asfeilli	azfeilhi
aasfeillo	azfeilhi
asgoalc'hit	azgwalc'hi
asvoalc'hi	azgwalc'hi
azvelet	azgweloutazgwelet
azwelout	azgweloutazgwelet
azgwerzet	azgwerzha
Aslavaret	azlavarout
Aslavarout	azlavarout
azlonka	azlonka
asmir	azmir
hazober	azober
azrannou	azrann
azvent	Azvent
visenadvnt	Azvent
visenAvnd	Azvent
misenavnd	Azvent
asveuli	azveuli
pabill	babilh
Babillerez	babilherez
Vabylon	Babilon
badinach	badinaj
badinellet	badinellet
badouell	baduell
paguig	bag
bagou	bag
ervag	bag
bag	bag
bak	bag
II	bag
bagoupesketa	bagpesketa
bagatelleu	bagatell
bagatellage	bagatellaj
vagatellage	bagatellaj
bagatellage	bagatellaj
bagatellaj	bagatellaj
bagueryen	bageer
bageer	bageer
vageerien	bageer
bageer	bageer
bailhadou	bailhad
baioneteso	baionetez
bayonetez	baionetez
bayounettez	baionetez
baleant	baleant
baleanted	baleant
arvaleanted	baleant
bali	bali
balisantJakez	bali
BalianN	bali
bali	bali
balustr	balustr
balustr	balustr
baluzt	balustr
eurbalustrou	balustr
balustraden	balustradenn
bandeu	bandev
banklabour	banklabour
banquerion	bankerbankour
Barabrased	barabrazed
vara	barabrazed
brazed	barabrazed
Baragad	baragad
baramouchen	baramouchenn
Baran	baraenn
urvaraen	baraenn
ervaran	baraenn
baraen	baraenn
barbar	barbar
barbelec	barbellek
barbouellet	barbouellet
barbouill	barbouilh
varilliad	barilhad
barnerabeoc'h	barnerabeoc'h
Barnourabeoc'h	barnerabeoc'h
barnerabeoc'h	barnerabeoc'h
varneranniliz	barnerIlizbarneranIliz
baro	baro
bar	barr
barrbrandon	barrbrandon
barliver	barrliver
baraouoc	barraouek
barriquad	barrikad
barrleun	barrleun
barvok	barveg
barvek	barveg
barvegez	barvegez
Barver	barverbarvier
barvryen	barverbarvier
barvier	barverbarvier
Barvouskennou	barvouskenn
basefoz	basefos
bassefos	basefos
bascanad	baskanad
bastardet	bastardet
bastard	bastardez
bastet	bastet
Bastien	Bastian
batissour	batisour
battounet	batona
batorellet	batorellet
arvatouil	batouilh
bavard	bavart
Bazar	bazar
bazannarar	bazhanarar
arvazroal	bazhroial
eurvazroue	bazhroue
bac'hateet	bazhataet
basilicg	bazilik
b	b
bec'hian	bec'hiabec'hi
bchekh	bechig
bechik	bechik
bechein	bechi
honbede	bede
bedelled	bedell
Beek	beekbek
Beek	beekbek
Mari	begaraok
BecgDouar	begdouar
begouDoar	begdouar
begdouar	begdouar
kuitaatarbekdouarman	begdouar
bekfuzil	begfuzuilh
bekfuzil	begfuzuilh
begadou	begad
Beegad	begad
begad	begad
begajou	begad
bgadeu	begad
begad	begad
bgad	begad
eu	begad
begad	begad
begad	begad
begadik	begad
begad	begad
avgad	begad
begatebet	begad
begelbolz	begelbolz
beguelyyen	begelieg
barab	beig
beillerez	beilherezh
beizik	beizik
beizik	beizik
beizik	beizik
beizik	beizik
becqedigou	beked
belostou	belost
Anasqornbelost	belost
belostou	belost
bilostou	belost
Bertram	Beltram
bemdezordinal	bemdezordinal
benadurez	benadurezh
venadurez	benadurezh
benadurez	benadurezh
benezet	benezet
benezet	benezet
benezet	benezet
benezet	benezet
gwenterc'henn	benterc'henn
beonou	beon
bourlikhabourlok	berlikhaberlok
bernvarvern	bernwarvern
bernvarvern	bernwarvern
berboellidigez	berrboellidigezh
berrentez	berrentez
berrentez	berrentez
Brant	berrentez
goezaerverrentez	berrentez
berrentez	berrentez
Berric	Berrig
berveled	berrwelet
bervelet	berrwelet
berteikberteiktout	berteik
bero	berv
tommbero	berv
bezroue	besroue
bezroue	besroue
beteneuze	beteneuze
Beteghen	betekhenn
betechen	betekhenn
be	beu
beugisal	beugisal
beulzet	beulzet
dourioubeuz	beuz
dourbeuz	beuz
dourbeuz	beuz
dourbeuz	beuz
BeuzitConogan	BeuzidKonogan
beobuez	bevbuhez
beobuez	bevbuhez
bevech	bewechbewezh
beveach	bewechbewezh
bevech	bewechbewezh
bevech	bewechbewezh
Bevechma	bewechbewezh
beveachma	bewechbewezh
beveichma	bewechbewezh
bezina	bezhina
besiadou	beziad
beziad	beziad
biein	bezia
besia	bezia
vezia	bezia
vezia	bezia
bibis	bibisbibisig
ed	bid
bida	bida
bidao	bida
edibidi	bidiez
bidac'h	bidoc'h
Biel	Biel
byellou	biell
bigot	bigod
bigod	bigod
dennabillet	bilhed
billejou	bilhedvot
beulim	binim
beneguedein	binnigedi
Beniguedet	binnigedi
bisou	bis
vis	bis
ervioh	bioc'h
ar	bir
vir	bir
bire	bir
bireu	bir
bir	bir
birvik	birvik
beruikinegh	birvikenegezh
bichigo	bisig
blach	blach
blankik	blank
blank	blank
blank	blank
Blasfematored	blasfematour
blasfemereah	blasfemerezh
blas	blaz
Arvlaz	blaz
blaz	blaz
urvlas	blaz
vlas	blaz
blazenn	blazenn
urvlazenn	blazenn
marc'hbleyn	blein
marc'hblein	blein
vleys	bleizez
eurvammvleizez	bleizez
blejadek	blejadeg
bljer	blejer
bleudran	bleudran
Blenhan	bleuvanhav
BlenarSakramant	bleuvarSakramant
Blennvez	bleuvnevez
blifig	blifik
bloavechennou	bloavezhienno
o	blod
blondin	blondin
blonsadurez	blosadurezh
Bou	bo
divoc'h	boc'h
divoc'h	boc'h
diouvoc'h	boc'h
divoc'h	boc'h
boc'herez	boc'herezh
bodad	bodad
bodennet	bodennet
bodennet	bodennet
bodennet	bodennet
bodennet	bodennet
bodennet	bodennet
bodennuz	bodennus
Vodiliz	Bodiliz
Bothsorel	Bodsorc'hel
bokodzadJozeb	bokedsantJozeb
boquedec	bokedek
o	bolad
bolead	bolead
volea	boleaboleatbolei
Bolei	boleaboleatbolei
boleet	boleaboleatbolei
boleat	boleaboleatbolei
boleu	bolo
bobardiogoz	bombardiougozh
vonjourein	bojouri
o	borod
boseal	boseal
bosein	boseal
boset	boset
bostadet	bostadet
Botezlouz	botezlous
votinesen	botinezenn
Bothoa	Botoha
boubou	boubou
Bouchikgavr	bouchiggavr
bouc'heed	bouc'haet
boedgouen	bouedgwenn
boedenhelost	bouedennlost
bonnfamm	boufam
boufonage	boufonaj
toulbouger	bougre
bouilla	bouilhas
bouillasou	bouilhas
boulvers	boulvers
Bourbounenn	bourbonenn
arVourc'hVenn	Bourc'hWenn
arVourc'hvenn	Bourc'hWenn
eurvorc'haden	bourc'hadenn
eurvourc'haden	bourc'hadenn
bourc'hadenou	bourc'hadenn
boud	bourd
bourda	bourda
bourret	bouret
vourret	bouret
bourret	bouret
bourreverez	bourevierezh
arvourreviez	boureviezh
Vourgez	Bourjez
bourjina	bourjin
bourjin	bourjin
bourkiz	bourkiz
bourouel	bourouell
mourouellat	bourouellatbourouella
bourouz	bourouz
bourret	bourret
bourrus	bourrus
Bourruss	bourrus
bourust	bourrus
bourus	bourrus
bourrussoh	bourrus
gobrbourrus	bourrus
bourrus	bourrus
bistouff	boustouv
bistouffou	boustouv
boustouf	boustouv
boustouf	boustouv
arvousellenvoan	bouzellennvoan
brabanser	brabaser
vrea	brae
Brae	brae
brei	brae
braead	braeabraealbraeatbraeiatbraei
evrellou	braelli
bragaouet	bragaouet
bragezek	bragezeg
bragoniou	bragonio
brall	brall
azoebrall	brall
etloevrall	brall
brandign	brandign
branellotreid	branelldreid
Branguilly	Brangilli
Braniellat	braniellat
arvranken	brankenn
brankodet	brankodet
Blaouahet	braouac'het
blaouahet	braouac'het
brasseletez	braseletez
brazkempenn	braskempenn
vraventez	braventez
braoenteziou	braventez
braventeziou	braventez
braoenteziou	braventez
braoiri	braviri
Bre	bre
Breo	brean
brche	brech
brec'hhabrec'h	brec'hhabrec'h
breac'hhabreac'h	brec'hhabrec'h
arvreac'hzu	brec'hzu
brec'hdu	brec'hzu
breffamant	brefamant
brein	brein
vrein	brein
brein	brein
breintuf	brein
breinteil	brein
brein	brein
brein	brein
breinadur	breinadur
brenadur	breinadur
brinnoni	breinoni
breinoni	breinoni
breizad	breizhat
brejo	brejeo
eion	brell
brellentez	brellentez
Bremaik	bremaik
bremaik	bremaik
bremaik	bremaik
bremaik	bremaik
bremaik	bremaik
bremaik	bremaik
bremak	bremaik
Bremandiveza	bremadiwezha
bremadiveza	bremadiwezha
brematreta	brematreta
Brenniliz	Brenniliz
breollyou	breol
brezerienfank	breserfank
bresermein	bresermein
bresq	breski
breta	brete
breta	brete
Breta	brete
breta	brete
breta	brete
brete	brete
breton	breton
breuiou	breuiou
breo	brev
brev	brev
edbrezelidi	brezeliad
Brezeliad	brezeliad
Brejed	brezet
bryata	briata
briaterez	briataerezh
brigantet	brigand
brignene	brignenennbrignonenn
brillantoc'h	brilhant
brinienn	brinienn
vrinien	brinienn
brehguen	brizhgwenn
brizaotrou	brizhaotrou
brizaotrouien	brizhaotrou
brizdescadurez	brizhdeskadurezh
brizdiod	brizhdiot
brizlenn	brizhlenn
brizbrezounek	brizhvrezhoneg
brisvenn	brizhwenn
grizilloned	brizilhonet
grizillonit	brizilhonibrizilhona
brechen	brochenn
brechin	brochenn
eurvrochen	brochenn
brochenneu	brochenn
brochennet	brochennet
broc'higargwenan	broc'higargwenan
broudryen	broder
brouderez	broderezh
broiouhuel	broiouhel
bronchan	brocha
brondu	brondu
brondu	brondu
reinbronnichaoda	bronnichao
brousta	brousta
brumennet	brumennet
brunard	brunard
bruteet	bruteet
bruhun	bruzun
bruzun	bruzun
brehoneu	bruzun
brehunadeu	bruzunad
bruzunadou	bruzunad
bruzunek	bruzunek
Bruzunenni	bruzunenni
bual	bual
bugadet	bugadet
buguelnos	bugelnozbugulnoz
buguelnoz	bugelnozbugulnoz
BugelNoz	bugelnozbugulnoz
bugalah	bugeliezh
begulenod	bugulanaod
bugulseud	bugulsaout
urvugulsdevd	bugulezdeved
vuhereah	buherezh
buezet	buhezet
buezet	buhezet
bureoubutun	burevbutun
bureobutun	burevbutun
burhudet	burzhudet
Butunfri	butunfri
butunkarrot	butunkarot
butunpoultr	butunpoultr
chaffod	chafod
chaffaud	chafod
chafodou	chafod
chafod	chafod
chafot	chafod
chafot	chafod
chagrin	chagrin
chagrinieu	chagrin
sagrin	chagrin
jagrin	chagrin
chagrinet	chagrinet
chagrinet	chagrinet
sagrined	chagrinet
sacot	chakot
chal	chal
Chal	chal
Bezaechalgant	chal
echal	chal
echal	chal
gant	chal
bezaechalo	chal
echalbotomp	chalbotat
chalquet	chalket
chalquet	chalket
chalmeu	chalm
chalounessou	chalones
chansuz	chasus
chansuz	chasus
chakeinchakalchagein	chaokatchaokachaoki
chokat	chaokatchaokachaoki
chakadpaterou	chaokatchaokachaoki
'nonchakat	chaokatchaokachaoki
jaossi	chaosi
chapelarvadisiant	chapelvadez
chapeledin	chapeledachapeledichapeletat
charn	charn
charreterez	charreterezh
chass	chas
chas	chas
chatalcorn	chatalkorn
chatalkorn	chatalkorn
chegad	chegad
cheket	cheka
chif	chif
chiffeu	chif
chif	chif
chiffein	chifachifalchifi
echiffou	chifachifalchifi
Chifal	chifachifalchifi
chifa	chifachifalchifi
chifa	chifachifalchifi
ched	chik
chiquet	chiket
chicoloden	chikolodenn
chilp	chilp
chilp	chilp
alumetezchimic	chimik
allumeteschimig	chimik
chitryen	chinter
chipotal	chipotalchipotat
Chipotal	chipotalchipotat
chipotalchipotat	chipotalchipotat
chipotal	chipotalchipotat
Chipotal	chipotalchipotat
chipotaloc'h	chipotalchipotat
chismatikerez	chismatikerezh
choget	choazet
chomadur	chomadur
ereahechoumadur	chomadur
chopet	chopet
achorme	chormi
achorme	chormi
Chormi	chormi
echorme	chormi
chouis	chouis
chouket	chouket
o	chour
chouri	chourachouri
choura	chourachouri
chouriquereah	chourikerezh
chouriquereah	chourikerezh
chutelad	chutellat
chutellat	chutellat
c'harlatanet	c'harlatanet
c'hoargaer	c'hoargaer
C'hoarleaz	c'hoarlaezh
c'hoarezedmager	c'hoarvager
c'hoarvager	c'hoarvager
hoarielleu	c'hoariell
c'hoariellou	c'hoariell
c'hoariel	c'hoariell
c'hoariellou	c'hoariell
c'hoariellou	c'hoariell
c'hoariel	c'hoariell
c'hoariellachou	c'hoariellajo
c'hoariellerez	c'hoariellerezh
hoarhereah	c'hoarzherezh
c'houerventez	c'hwerventez
c'hoet	c'hwet
c'hoetan	c'hweta
c'hoezadennou	c'hwezadenn
c'huezadur	c'hwezadur
c'huezeccant	c'hwezekkant
C'houezekuget	c'hwezekugent
c'houipc'huib	c'hwib
c'huybanadou	c'hwibanad
huibeden	c'hwibedenn
c'hwiledbouzel	c'hwilbeuzel
huilcrugud	c'hwilkrug
c'hwiltouzien	c'hwiltouz
C'houirinadenn	c'hwirinadenn
C'houirinal	c'hwirinalc'hwirinatc'hwirini
c'hwirignal	c'hwirinalc'hwirinatc'hwirini
c'houistim	c'hwistim
c'houit	c'hwit
dadouez	dadouez
dadouez	dadouez
d'egaout	dagaout
d'hokaout	dagaout
Dagenver	dagever
daguever	dagever
devesque	davesk
devisq	davesk
davesk	davesk
Chegat	dachegat
Dachegad	dachegat
dacor	dakor
C'hoaridalanao	dalanao
dalc'hmad	dalc'hmat
Daleer	daleer
dalletoc'h	dalet
dallpeell	dallpezhell
Dallpikh	dallpik
dallput	dallput
dallput	dallput
dallput	dallput
Dalvez	dalvez
demalaouret	damalaouret
demanaout	damanavezout
dambonr	damboner
dambonr	damboner
d'amgrons	damc'hros
demc'huero	damc'hwerv
damholl	damholl
damholl	damholl
damholl	damholl
damn	damn
damgroet	damober
damoezok	damoezek
damzec'h	damsec'h
demvelen	damvelen
demvelen	damvelen
damdon	damzon
danjer	dajer
zangr	dajer
zanjer	dajer
Danjer	dajer
Danserien	daser
dantelezi	dantelezi
dantier	dantier
Daouc'hant	daouc'hant
daouc'hant	daouc'hant
deuguent	daouugent
deuuguent	daouugent
daouugent	daouugent
daou	daoubleget
bleguet	daoubleget
daoubleget	daoubleget
daoubleget	daoubleget
daoubleget	daoubleget
zaoudec	daoudek
Daoulampat	daoulammatdaoulemel
Daoulinet	daoulinet
Daouugentved	daouugentvet
Daouzekuget	daouzekugent
daouzecvet	daouzekvet
Daouzekved	daouzekvet
darbarerez	darbarerezh
darc'ha	darc'ha
dardec	dardek
voardareden	dare
darempret	darempred
derempreded	darempredet
darempredet	darempredet
darnet	darnet
darondel	darondell
darz	darz
dasse	dase
Dastaz	dastaz
dastaz	dastaz
davoyet	daveet
dibord	debord
spered	debret
spereddebret	debret
digervel	dec'hervel
tic'halvas	dec'hervel
ezeden	dedennadedenn
didenna	dedennadedenn
boudedeo	dedeo
didostaidiguez	dedostaidigezh
didreuset	dedreuzi
etiflistraz	deflistra
degaget	degajet
degas	degasdegasi
degas	degasdegasi
ezigasshed	degasdegasi
digassendro	degasdegasi
huiezegasschongeteign	degasdegasi
zigasontdazonjda	degasdegasi
azigas	degasdegasi
deisiadet	deiziadet
dejanal	dejanaldejani
dekoranz	dekoras
deledan	delledan
oberdelerda	deler
Delfinez	delfinez
telio	deliaouenn
zeliu	deliaouenn
dellezour	dellezour
dellido	dellid
Delliddellit	dellid
dellidou	dellid
DenaIliz	denaIliz
zenalezen	denalezenn
Denavrezel	denavrezel
ed	devedenn
deveden	devedenn
deveden	devedenn
zeveden	devedenn
deveden	devedenn
deolediguez	deoledigezh
enemzepita	depita
deputeed	depute
derc'hentdeac'h	derc'hentdec'h
Ennderc'hentdeac'h	derc'hentdec'h
dereadez	dereadezh
direzed	derezet
dero	derv
derv	derv
dero	derv
dero	derv
dero	derv
Zero	derv
dero	derv
guezdero	derv
zero	derv
dero	derv
fid'andero	derv
derveq	dervek
erwen	dervenn
derven	dervenn
dervennou	dervenn
dervennou	dervenn
dervet	dervet
dijanchet	desacha
despeigni	despegni
despeigni	despegni
despeigni	despegni
Despeignit	despegni
azespez	despezhi
despezus	despezhus
Divirous	deverus
dervesiad	devezhiad
dervesiad	devezhiad
derveziad	devezhiad
devesiad	devezhiad
derveziad	devezhiad
devor	devor
dvorant	devorant
devotius	devotius
devotius	devotius
dezert	dezert
desert	dezert
diabadaouas	diabadaoui
diabafet	diabafet
diabeg	diabeg
diabusein	diabuzi
diachap	diachap
aziadost	diadost
diadraou	diadraodiadraou
aziadr	diadro
diez	diaez
ziez	diaez
ara	diaez
diagned	diagon
diaket	diaket
ziacouragein	diakouraji
diali	diali
ziam	diam
diamant	diamant
diamant	diamant
ziamanchou	diamant
diamant	diamant
diambarassi	diambarasi
enemdiambarassi	diambarasi
enemdiambarassi	diambarasi
diamn	diamen
diamen	diamen
diamn	diamen
diamnd'	diamen
diamezec	diamezek
dioc'h	diamezek
diamodein	diamoedi
diamors	diamors
diamzer	diamzer
dic'heladen	dianaladenn
dianav	dianav
dianaves	dianavez
diankachou	diankajo
diankenia	diankeniadiankenat
zianvet	dianvet
dianzavou	dianzav
diansao	dianzav
dianzao	dianzav
diamzavet	dianzavet
Diasavet	dianzavet
diaonig	diaonik
Diaoulez	diaoulez
diozet	diaozet
ziapprouet	diaproui
diar	dir
diar	dir
diar	dir
diaraoguet	diaraoget
diarvar	diarvar
diasclez	diasklez
chomendiascrenn	diaskren
choumwarziaskren	diaskren
diasur	diasur
diatant	diatant
Diatat	diatant
diavez	diavaez
diaveasbro	diavaezbro
diavaezidi	diavaeziad
diahulccan	diavelek
diavisted	diavizded
diazemant	diazezamant
dibabed	dibabet
dibaduz	dibadus
dibayannet	dibaiani
dibalpous	dibalpous
dibaotre	dibaotre
dibarquein	dibarki
dibask	dibask
dibave	dibavez
dibelt	dibelt
diben	dibenn
dibennask	dibennask
diberc'hennet	diberc'hennadiberc'henni
dibermet	dibermet
dibistig	dibistig
diblas	diblas
diblas	diblas
diblas	diblas
diblass	diblas
diblas	diblas
diblas	diblas
dibled	dibled
dibled	dibled
aziboanie	diboaniadiboanii
dibonein	diboaniadiboanii
diboniein	diboaniadiboanii
enemziboania	diboaniadiboanii
diboaniet	diboaniet
diboell	diboell
Diboell	diboell
diboell	diboell
diboell	diboell
diboel	diboell
Diboella	diboelladiboelli
aziboello	diboelladiboelli
diboumbel	dibombell
diboumbel	dibombell
tibordel	dibordal
ziboulzo	diboulza
diborrodet	dibourrodi
dibourvance	dibourvezas
dibratik	dibratik
dibrenest	dibrenestr
dibrenn	dibrenn
azibreved	dibreveda
dibrepar	dibrepar
dibrezet	dibreza
Dibuchomp	dibucha
dibuneresed	dibunerez
dibunerez	dibunerez
dibunourou	dibunouer
dijadenn	dichadenn
dijaden	dichadenn
dichadennet	dichadennet
dijadennet	dichadennet
dichagrin	dichagrin
dizagrin	dichagrin
dijagrin	dichagrin
dichaladur	dichaladur
dic'haloupat	dic'haloupat
azic'haloup	dic'haloupat
dichans	dichas
dichanz	dichas
dichans	dichas
tic'harvi	dic'harvi
dichelpa	dichelpa
dichelpan	dichelpa
dic'hiz	dic'hiz
dic'hiz	dic'hiz
Dic'hlac'har	dic'hlac'hari
dihlaharet	dic'hlac'hari
dic'hlac'haraz	dic'hlac'hari
dic'hlac'haret	dic'hlac'hari
dic'hlac'hari	dic'hlac'hari
diglac'hari	dic'hlac'hari
enemzic'hlac'hari	dic'hlac'hari
enemzic'hlac'hari	dic'hlac'hari
enemzic'hlac'haras	dic'hlac'hari
dic'hoarz	dic'hoarzh
zic'hodella	dic'hodella
dic'hourda	dic'hourda
dic'hourda	dic'hourda
dic'hout	dic'hout
dic'hout	dic'hout
dic'hout	dic'hout
Dec'hradi	dic'hradadic'hradi
dic'habouz	dic'habous
dic'halloudez	dic'halloudezh
dic'haouet	dic'haouet
dic'hizet	dic'hizet
dic'hiseten	dic'hizet
diguiset	dic'hizet
dic'hlac'har	dic'hlac'har
dic'hlan	dic'hlan
dic'hlann	dic'hlan
dic'hlaignet	dic'hlanniet
dic'hloar	dic'hloar
dic'hloar	dic'hloar
dic'hloar	dic'hloar
zic'hoantaad	dic'hoantaat
Enemzic'hoantaad	dic'hoantaat
dic'hoanteguez	dic'hoantegezh
dic'hoanteguez	dic'hoantegezh
dic'hoantegez	dic'hoantegezh
dic'hoanteghez	dic'hoantegezh
dic'hoarzet	dic'hoarzhet
dihouillet	dic'houilhet
dic'hounez	dic'hounez
Dic'hounez	dic'hounez
dihoustet	dic'houstet
dic'houtet	dic'houtet
dic'houtet	dic'houtet
dic'houtet	dic'houtet
dic'houtas	dic'houti
dic'hoti	dic'houti
dic'houti	dic'houti
enemzic'houti	dic'houti
dious	dic'houti
dic'hougadenn	dic'houzougadenn
dic'hradet	dic'hradet
dic'hrasiet	dic'hrasiet
enemdic'hrocha	dic'hroja
dic'hrochek	dic'hrojek
dic'hrochet	dic'hrojet
dic'hrosmol	dic'hrozmol
dic'hoero	dic'hwerv
dic'houibu	dic'hwibu
didach	didach
didach	didach
didach	didach
didach	didach
didach	didach
didach	didach
didachabec'het	didach
Didaill	didailh
didamman	didammadidammi
enemzidama	didammadidammi
didamet	didammet
didamet	didammet
Didanfouestret	didanfoestra
Azidenvo	didevidideva
Dider	Dider
etitiruiller	didiruilha
didok	didog
didorgenn	didorgenn
didortil	didortilh
didortill	didortilh
didou	didou
didrafik	didrafik
edrohagezidro	didrei
treuzididreuzi	didreuzadidreuzi
didroel	didroell
didroel	didroell
didroell	didroell
didroel	didroell
didroel	didroell
Didrompein	didrompladidrompli
didrompet	didromplet
didroubloc'h	didroubl
didruhdigueah	didruedigezh
onda	didu
diegustet	diegusted
dihelkadenn	dielc'hadenndihelc'hadenn
diempennidigez	diempennidigezh
diencrez	dienkrez
dienkres	dienkrez
diencrezet	dienkrezet
diann	dienoe
dionnnnourou	dieonennouer
dielbed	dierbed
dierc'h	dierc'h
Dieubi	dieubi
dieubi	dieubi
dieubi	dieubi
enemzieubi	dieubi
Dieul	dieul
dieveset	dievezhet
enemzifsa	difaezha
divagannet	difaganet
difazius	difazius
difeisa	difeiz
difeiz	difeiz
difeiz	difeiz
dife	difeiz
difeiz	difeiz
difeiz	difeiz
difeiz	difeiz
diffret	diferi
difonded	difesonded
diferm	difeurm
diferm	difeurm
difiadeg	difiadeg
defian	difias
difin	difina
difinves	difinvezh
difiance	difizias
difianus	difiziasus
zifiziout	difiziout
flastrethadifflastret	diflastra
diflat	diflatrdiflat
diflat	diflatrdiflat
Diflat	diflatrdiflat
diflat	diflatrdiflat
diforhet	diforc'hidiforc'hadiforc'h
eziforhas	diforc'hidiforc'hadiforc'h
diforc'hein	diforc'hidiforc'hadiforc'h
difforhance	diforc'has
difforhance	diforc'has
difougue	difouge
difougue	difouge
difouge	difouge
difourbouilh	difourdouilh
difourret	difourra
diffoutre	difoutredifoultre
difreat	difraeaat
difreaz	difraezh
Diframm	diframm
Diframm	diframm
ziframm	diframm
difranjellat	difrajellat
enemzifraoia	difraoia
difrost	difraost
difraostet	difraostet
difreguet	difreget
difreio	difreio
enemzifres	difres
difrez	difrez
difrink	difrink
efrinkashagetifrinkas	difrinka
Difrouezidiguez	difrouezhidigezh
difrouezedigez	difrouezhidigezh
difrouezidigez	difrouezhidigezh
difuc'ha	difuc'ha
difulia	difuilha
difuilla	difuilha
nezifuillinket	difuilha
difuillet	difuilhet
furchethadifurchet	difurchal
digalon	digalon
digalon	digalon
digalounkeat	digalonekaet
digapapl	digapapl
digelionenn	digelienenni
dic'henedet	digenedet
tic'henedi	digenedi
Dic'henedet	digenedi
digenter	digenter
Diginklet	diginklet
digloset	digloset
diglosset	digloset
digloz	digloz
digoadet	digoadet
digoch	digoch
digokadigoga	digoka
digoumpagnoun	digompagnun
digompez	digompez
Digompez	digompez
digompez	digompez
digomprenable	digomprenapl
digor	digor
dyr	digor
digor	digor
digor	digor
digor	digor
digor	digor
digor	digor
fermdigor	digor
zigor	digor
digor	digor
digor	digor
digorhegaloun	digor
dgorrijabl	digorrijapl
azigouezaz	digouezha
dgoursein	digoulzi
digoumoul	digoumoul
digoumoul	digoumoul
digopet	digoupet
digourachet	digourajet
digourachi	digouraji
digoust	digoust
digoustians	digoustias
digoustianz	digoustias
digoustianz	digoustias
digoustians	digoustias
zigrdereah	digrederezh
digredoni	digredoni
etigreske	digreski
digreski	digreski
digrogennet	digrogennet
digropet	digropet
digondu	digundu
Dialan	dihala
dihalpet	dihalpet
dihouilhet	dihouilhet
dijell	dijell
dijiletenn	dijiletenn
dijunet	dijunidijunadijunia
dilabour	dilabour
dilabour	dilabour
dilabour	dilabour
dilabour	dilabour
dilabour	dilabour
dilausq	dilaosk
dlausque	dilaosk
dilavet	dilavet
dilavet	dilavet
dillatvele	dilhadgwele
dilladvele	dilhadgwele
dilladguele	dilhadgwele
dilad	dilhadgwele
dilhadet	dilhadet
diliamm	diliamm
Dilihet	dilihet
dilikeda	dilikeda
dilivran	dilivras
dilivrans	dilivras
delivrans	dilivras
delivrans	dilivras
dilizer	dilizher
diloc'het	diloc'het
dilogodtet	dilogotadilogotat
dislontret	dilontretdislontret
dilorhas	dilorc'ha
dilostet	dilostadilosti
tilosta	dilostadilosti
dilotet	dilotet
dilovret	dilovri
dilovret	dilovri
dilu	dilu
diluc'het	diluc'ha
diluiet	diluziet
demeus	dimeus
Demeus	dimeus
demeus	dimeus
dimez	dimeus
Demeus	dimeus
demeuz	dimeus
dimez	dimez
dimez	dimez
dinac'h	dinac'h
dinac'hiou	dinac'h
Dinac'h	dinac'hidinac'hadinac'h
dinahein	dinac'hidinac'hadinac'h
zinac'h	dinac'hidinac'hadinac'h
dinac'ha	dinac'hidinac'hadinac'h
dinahein	dinac'hidinac'hadinac'h
dinaturi	dinaturadinaturi
Dinaturdet	dinaturded
etinavont	dinavi
dineat	dinead
dinec'h	dinec'h
dinec'h	dinec'h
zinec'hi	dinec'hi
dinec'hi	dinec'hi
zinec'hi	dinec'hi
dinec'hi	dinec'hi
dineei	dinezadinezi
diniverapl	diniverapl
dinoblanz	dinoblas
dinobli	dinobli
dis	dis
disu	dis
diz	dis
Disal	disaldisi
dizez	disez
diaboissance	diobeisas
diaboissance	diobeisas
diodet	diodet
diodet	diodet
Diorroit	diorren
ziorren	diorren
diotiez	diotiezh
ziouech	diouch
diouech	diouch
dioueraat	dioueraat
diouered	diouered
zihouyedigueah	diouiziedigezh
diouc	diouiziek
divouiek	diouiziek
dihouyc	diouiziek
dihouiec	diouiziek
dic'houezchek	diouiziek
dihouec	diouiziek
diviziek	diouiziek
Dirabansi	dirabasi
aziraillaz	dirailha
dirange	diraj
Direngennet	dirajennet
diranget	dirajet
diranget	dirajet
diranget	dirajet
diranget	dirajet
dirankont	dirankontr
dirann	dirann
dirann	dirann
Diranned	dirannet
daziransa	dirasadirasidiras
dirglet	direglet
Direktoer	direktoer
direligion	direlijion
diremor	diremorz
diremorz	diremorz
direnk	direnk
zireoli	direoli
direunet	direunet
dirsonabl	direzonapl
diraizouni	direzoni
Ribouldiriboul	diriboul
riboul	diriboul
tiridignat	diridignat
aziriklas	dirikla
dirilla	dirilha
dirisq	diriskldirisk
diriskl	diriskldirisk
diriskl	diriskldirisk
dirohei	diroc'haldiroc'hatdiroc'hi
dirodet	diroda
enemdirodelenni	dirodellenni
diroll	diroll
diroll	diroll
diroll	diroll
diroll	diroll
dirouestl	dirouestl
diroufennit	diroufenna
eziroulr	dirouli
dirrou	dirrou
I	dis
dis	dis
enemzisa	disa
disadorn	disadorn
dizae	disae
disaezit	disaez
dizacr	disakr
dizakr	disakr
dizakr	disakr
dizaoured	disaouret
dizaouti	disaouti
dizao	disav
dis'hlac'har	disc'hlac'har
disc'hlac'har	disc'hlac'har
disc'hlac'harin	disc'hlac'hari
dizebezet	disebezet
enemdizec'hedin	disec'hedi
dishet	disec'het
disshet	disec'het
disshet	disec'het
dizec'het	disec'het
dizec'het	disec'het
disentamant	disentamant
dizervel	diservel
zisfe	disfeiz
disfi	disfizdisfi
difiadeg	disfiziadeg
tisfi	disfizioutdisfiout
disc'hlac'har	disglac'har
azisgrcias	disgrasia
diswe	disgwe
diswe	disgwe
disvinta	disgwinta
Dishavaldt	dishavalded
dishavaledigueah	dishavaledigezh
dishavalet	dishavalet
dizharp	disharp
dishentcha	dishenta
dishenvelded	dishevelded
dishorellet	dishorellet
dizhualet	dishualet
dizikour	disikour
dissimur	disimur
enemzisipa	disipa
disjointret	disjoentret
diskou	disk
disco	disk
disqueu	disk
discalon	diskalon
discalon	diskalon
discalonc	diskalonek
discalonc	diskalonek
discampet	diskampa
tiscampa	diskampa
aziscampaz	diskampa
aziscamp	diskampa
diskareo	diskaranhav
ziskargerguin	diskargergwin
adiskeilfe	diskeilha
diskenndour	diskenndour
ziskianted	diskianted
diskianteka	diskiantek
disklenk	disklenk
disclration	disklrasion
disclration	disklrasion
disclration	disklrasion
diskoazel	diskoazell
discolpryen	diskolper
disconterez	diskonterezh
ziscontinuein	diskontinui
tiskornadi	diskornadi
diskorpul	diskorpul
diskorpul	diskorpul
diskoulm	diskoulmadiskoulm
Diskoulma	diskoulmadiskoulm
disklommein	diskoulmadiskoulm
discouragement	diskourajamant
tiscouragemant	diskourajamant
discouraget	diskourajet
discrabet	diskrabadiskrabatdiskrab
discred	diskred
endefediskredvar	diskred
ediskred	diskred
discreden	diskredenn
ziskreden	diskredenn
diskrid	diskrid
diskroc'hen	diskroc'hen
diskrignet	diskrognet
discrognet	diskrognet
discrognet	diskrognet
diskuil	diskuilh
diskuill	diskuilh
discuilldioc'h	diskuilh
diskuzet	diskuzha
dislam	dislamm
dislealamant	dislealamant
disliamma	disliamma
zisliama	disliamma
dislonk	dislonk
dislonket	dislonket
disluhet	disluhet
Dissmantein	dismantradismantridismantr
dismanta	dismantradismantridismantr
zismantri	dismantradismantridismantr
etismantre	dismantradismantridismantr
humzismantou	dismantradismantridismantr
dismeget	dismega
azismeghint	dismega
disnol	disnol
disocher	disocher
dizoroc'h	disoc'hor
dissorb	disorb
dissorb	disorb
dissorb	disorb
dissorb	disorb
dissorbet	disorbet
zizorc'heni	disorc'henni
dissouill	disouilh
dizouil	disouilh
disouil	disouilh
disouillet	disouilha
zissouciance	disoursias
zispag	dispak
dispar	dispar
Dispara	disparadisparidisparat
disparti	disparti
dispedet	dispedi
dispidi	dispedi
dispeg	dispeg
dispennadurcorf	dispennadurkorf
dispeur	dispeur
dispeuret	dispeuret
dispit	dispit
dispita	dispitadispital
zispital	dispitadispital
displica	displika
displica	displika
displica	displika
dispounta	dispont
dispouea	dispouea
dispostioneu	dispozision
dispositionou	dispozision
disposision	dispozision
Disputerien	disputer
distagerien	distager
distagerien	distager
distageriengevier	distager
distagergeoyer	distager
distalav	distalaf
distammet	distammet
distan	distan
distanshadistans	distashadistas
distladenn	distaoladenn
distaoladen	distaoladenn
distoei	disteidistoi
zisto	disteidistoi
disterved	disterved
disklapet	distlapadisklapa
disklapet	distlepel
otistoka	distokadistoki
distorlok	distorlok
zistrafuilla	distrafuilha
distrafuillet	distrafuilhet
distrap	distrap
distreina	distreina
distremein	distremen
distremp	distremp
distremp	distremp
distrilla	distrilha
distrobel	distrobell
distroc'heuliet	distroc'heulia
zistroedigueah	distroidigezh
azistrone	distrona
zisturia	disturia
disuport	disuport
disvalet	disvaladisvalat
disvantret	disvantret
zisvantri	disvantri
disvempra	disvempra
disvroet	disvroet
disvrot	disvroet
divab	divab
divahignet	divac'hagna
Divarc'hagnet	divac'hagna
zivadelez	divadelezh
divadez	divadez
divadezet	divadezet
Divadin	divadin
divadin	divadin
divean	divaen
tivaloa	divalava
divarc'heresdorejo	divarc'herezdorojo
divaskellek	divaskellek
diweskelleg	divaskellek
divazoulenna	divazhoulenna
divazoulennet	divazhoulennet
divehet	divec'hiadivec'hadivec'hi
divec'hia	divec'hiadivec'hadivec'hi
zivec'han	divec'hiadivec'hadivec'hi
diveiadagorf	divec'hiadivec'hadivec'hi
enemdivec'hiet	divec'hiadivec'hadivec'hi
divelc'houedi	divelc'hwedadivelc'hwedi
diveleien	diveleg
divent	divent
Divet	divent
divent	divent
eunniverdiventa	divent
divent	divent
divent	divent
diventur	diventur
diverc'h	diverc'h
diverdet	diverdet
divelgret	divergladivergli
ziverglberpet	divergladivergli
zivergla	divergladivergli
divrit	diverit
divilid	diverit
diverr	diverr
diveramzer	diverramzer
diveramzer	diverramzer
diveramzer	diverramzer
devrranceu	diverras
divezoni	divezhoni
divezusa	divezhus
tihantras	divhanteri
diouared	divharet
Dihuigut	diviget
dihuiguet	diviget
dihuiguet	diviget
divinet	divini
devisereah	divizerezh
humzivlammein	divlamadivlami
humzivlamein	divlamadivlami
divlaz	divlaz
divlaz	divlaz
divlaz	divlaz
Divlaz	divlaz
divlas	divlaz
divlas	divlaz
divlas	divlaz
blazahadivlaza	divlaza
divoaz	divoas
Divodrage	divoderaj
divodest	divodest
divodeste	divodest
Divodest	divodest
divodest	divodest
divodesti	divodesti
divodesti	divodesti
tivodestis	divodestiz
divodestis	divodestiz
divogidel	divogidell
divordein	divordadivordi
divorfil	divorfil
divorfil	divorfil
divorfil	divorfil
divorloh	divorloc'h
divors	divors
divot	divot
divot	divot
divot	divot
divot	divot
divoutou	divoto
divoutou	divoto
divoucher	divouchergoulo
divoudinella	divoudinella
divouedet	divouedet
divoueded	divouedet
divougus	divougus
Divoutet	divounti
divouton	divounton
divoutoun	divounton
divouttonei	divountona
Divoutona	divountona
divourabl	divourrapl
divoursein	divoursadivoursi
divoutou	divouti
divranselloc'h	divrasell
Divrasa	divrazadivrazi
divraset	divrazadivrazi
divraza	divrazadivrazi
divroidi	divroaddivroiad
divroad	divroaddivroiad
divroidi	divroaddivroiad
Divroidi	divroaddivroiad
divroad	divroat
divroad	divroat
divroedigueah	divroedigezh
divroegueah	divroegezh
diousklufet	divsklufet
etivuanekeont	divuanekaat
divuzuz	divuzus
diouallerez	diwallerez
divargount	diwargont
divarlaz	diwarlaez
divarzu	diwarzu
diwoarvar	diwarvar
divoask	diwask
diwastr	diwast
divelsont	diwelout
diveoc'h	diwezh
divez	diwezh
divez	diwezh
wardivez	diwezh
divez	diwezh
andivezadou	diwezhad
arendevhat	diwezhad
diwikhofreetdiwikhewret	diwikefreet
diwinkelat	diwinkelat
divisctog	diwisktog
zivisktog	diwisktog
zivisctog	diwisktog
dic'hri	diwri
dihouriadein	diwriziadi
dihouriadet	diwriziadi
diyahus	diyac'hus
diac'huz	diyac'hus
zialc'ha	diyalc'ha
dizabuzet	dizabuzet
tisabuzi	dizabuzi
dizac'heled	dizahelet
disalbad	dizalbad
disalbad	dizalbat
dizale	dizale
dizall	dizall
dizalled	dizalla
zizalla	dizalla
dizalla	dizalla
zizalla	dizalla
dizamantuz	dizamantus
dizampouezouni	dizampoezoni
ezihanadas	dizanadi
dishalana	dizanala
dizanaoudegez	dizanaoudegezh
dizanaoudek	dizanaoudek
dishanuettan	dizanavet
disanve	dizanavez
disanve	dizanavez
didanjur	dizajer
didatek	dizanteg
didatek	dizantek
azizantellaz	dizantella
dizatren	dizantren
dizatren	dizantren
dizaounica	dizaonik
dizaoni	dizaoni
dizarb	dizarb
disarfleuein	dizarfleui
dizarle	dizarle
dsavoein	dizavoui
dizefaut	dizefot
dizell	dizell
dizenoui	dizenoei
disenoui	dizenoei
disinoui	dizenoei
enemzizenoui	dizenoei
enemdizenoui	dizenoei
enemdizinoui	dizenoei
enemdisenoui	dizenoei
dizenous	dizenoes
disenoret	dizenoret
dizerc'h	dizerc'h
dizeret	dizereet
dizeriet	dizeriet
dizesc	dizesk
dizesk	dizesk
dizesk	dizesk
dizesk	dizesk
dizesperet	dizesperet
dizesperet	dizesperet
dizeur	dizeur
dizer	dizeur
diseur	dizeur
disur	dizeur
tizeur	dizeur
dizeur	dizeur
dizer	dizeur
dizevot	dizevot
dizillet	dizilha
dezinterez	dizinterest
dizispign	dizispign
dizispign	dizispign
dizizpin	dizispign
dizispign	dizispign
dizispign	dizispign
dizispign	dizispign
dizispign	dizispign
dizispin	dizispign
dizispign	dizispign
dizispign	dizispign
dislea	dizlea
enemzislea	dizlea
zislea	dizlea
dislea	dizlea
enondizoac'ha	dizoac'ha
didoan	dizoan
dizoan	dizoan
dizoan	dizoan
dizoan	dizoan
dizoan	dizoan
tizoan	dizoan
zizoan	dizoan
dizoan	dizoan
dizoania	dizoania
zizoboissa	dizoboisa
didommagein	dizomaji
dizomagein	dizomaji
dizonjer	dizojer
dsordre	dizordr
Dizorna	dizornadizornia
Dizorna	dizornadizornia
dizornet	dizornadizornia
dizougus	dizougus
dizroullans	dizroulas
dizunanet	dizunanet
azizunan	dizunani
dizunvan	dizunvan
disurch	dizurzh
disurzou	dizurzh
disurjo	dizurzh
zizursiou	dizurzh
dizursiou	dizurzh
dizurz	dizurzh
zizurs	dizurzh
dizurzet	dizurzhet
deliable	dleapl
deliabl	dleapl
delerion	dleour
dleour	dleour
zleour	dleour
delour	dleour
dleour	dleour
dleourien	dleour
dleour	dleour
dliour	dleour
dleour	dleour
adlevezo	dlevezout
adlevezo	dlevezout
adlevezo	dlevezout
adlevezo	dlevezout
adlevezo	dlevezout
doaniou	doan
hopetdoan	doan
Doan	doan
gaoutdoanvar	doan
doeh	doeh
domach	domaj
domajou	domaj
mareitdomaich	domaj
Dommach	domaj
Dominiq	Dominik
Dominik	Dominik
I	dov
davet	dovaet
orporched	dorborched
ennoreborh	dorborzh
anorborz	dorborzh
anorbors	dorborzh
norralhuourrerion	doralc'hwezer
dourdis	dorndis
dourneohdourne	dornouzhdorn
dornadek	dornadeg
dornerezou	dornerez
dornerez	dornerez
dournerez	dornerez
dornet	dornet
dornhibill	dornibil
dorneri	dorniri
dossereah	doserezh
docil	dosil
doarlabour	douarlabour
Douar	douarlabour
Douarmelen	douarmelen
melen	douarmelen
douarran	douarran
douartirien	douartirien
zouaraat	douaraat
douaren	douarenn
zouarenn	douarenn
Zouarneneziz	Douarneneziz
Douarneneziz	Douarneneziz
toubleal	doubleal
doubled	doubledie
doubleviou	doublevio
douez	douez
dougunda	dougeeun
Douguement	dougamant
dougerach	dougeraj
douj	douj
douj	douj
douj	douj
douj	douj
douj	douj
doujab	doujapl
dourbarr	dourbarr
deurbiue	dourbev
deurbihue	dourbev
zourbeo	dourbev
dourdiluch	dourdiluj
dourdiluch	dourdiluj
dourdiwask	dourdiwask
dourmelis	dourmelis
dourtan	dourtan
dourasen	dourasennek
dourbill	dourbilh
dourbill	dourbilh
dourbil	dourbilh
dourbill	dourbilh
dourbil	dourbilh
glaodourbil	dourbilh
dourvez	dourvez
dousenn	dousenn
dousen	dousenn
dousen	dousenn
Doucrus	douserus
douzigen	dousijenn
dousik	dousik
Doucig	dousik
zoutein	doutadouti
douteina	doutadouti
doutein	doutadouti
draillkorf	drailhkorf
zraillerh	drailherezh
drailvein	drailhvein
drastetgantarboan	drastet
hebiou	drebiou
drebiou	drebiou
drebiou	drebiou
drfin	drefin
drfoul	drefoul
dreguichen	dregichen
drgreiz	dregreiz
dregreiz	dregreiz
dregreiz	dregreiz
dregreiz	dregreiz
dregreiz	dregreiz
drgh	dreguzh
dreleac'hma	drelec'hma
drezerr	dreser
trhiet	drec'het
dreistbord	dreistbord
dreistholl	dreistholl
dreistoll	dreistholl
dreistoll	dreistholl
Dromeder	dremedal
dremedal	dremedal
zreok	dreog
draog	dreog
draoc	dreog
drettat	dretaat
dreug	dreug
dreo	drev
drodeu	droaddroed
droideu	droaddroed
troajou	droaddroed
drogach	drogaj
drougarchas	drougarchas
droukisili	drougizili
drougizili	drougizili
drougcalon	drougkalon
drouccostez	drougkostez
droukskiant	drougskiant
droukimpli	drougimplij
droukimplia	drougimplijout
troucentend	drougintent
zrougentent	drougintent
droukfizians	droukfizias
droukhanvel	droukhaval
nadroughanvalketouz	droukhavalout
droukkelou	droukkelo
droukklewet	droukklevoutdroukklevet
drouklagadet	drouklagadet
drouclam	drouklamm
drouklamm	drouklamm
drougpresegures	droukprezegerezh
droukprezegerez	droukprezegerezh
droukskiant	droukskiant
drougioulet	droukyoulet
druillennek	druilhennek
dardur	duardur
dudied	dudiet
dudiuz	dudius
dudiuz	dudius
dudius	dudius
dudius	dudius
Dukardenn	dukardenn
ebarznebeud	ebarzhnebeut
ebleo	eblev
dirak	edirak
edrek	edrek
efsonall	efesonall
ekeit	ekeit
Enqueithama	ekeit
ekeitamzerma	ekeitamzerma
enhec'herc'hen	ekerc'henn
enhegerc'hen	ekerc'henn
ecreizetre	ekreizetreekreiztre
ecreiztre	ekreizetreekreiztre
ecreizetrezo	ekreizetreekreiztre
ekreizetre	ekreizetreekreiztre
Ekroug	ekroug
enkrougeuz	ekroug
nvsq	emesk
nvesq	emesk
'nevesk	emesk
enhormesko	emesk
enomesk(o)	emesk
noumesq	emesk
enhomesk	emesk
noumesk	emesk
enperch	eperch
sigur	esigur
sigur	esigur
sigur	esigur
sigur	esigur
Eskeud	eskeud
heunan	eunan
hunan	eunan
hunan	eunan
hunan	eunan
heunanic	eunan
heheun	eunan
heunanpenn	eunan
heunankaer	eunan
eneeaz	eunan
eunan	eunan
eunan	eunan
ebad	ebat
azoebatdezo	ebat
ebatoahedoare	ebat
doare	ebat
ebateogantho	ebat
neketebad	ebat
n'eoketebad	ebat
d'eben	ebenheben
ebeuleuzed	ebeulez
edguenn	edgwenn
ituenutuen	edduenn
edok	edek
idenn	edenn
education	edukasion
effed	efed
Effejou	efed
effejou	efed
afferuz	eferus
efeeruz	eferus
efidandomen	efidandomenn
ephod	efod
MaEghinat	eginad
egos	egos
egras	egras
egras	egras
egras	egras
examplus	egzamplus
exemplus	egzamplus
exemplus	egzamplus
exemplus	egzamplus
egzesour	egzesour
exerci	egzersi
exorsis	egzorsiz
exhortou	egzorti
heil	eil
eilgosa	eilkosha
eilcosa	eilkosha
eilbeved	eilbeva
eilfurmed	eilfurmi
eilfurmi	eilfurmi
eillavaret	eillavarouteillavaret
eilblgou	eilpleg
eiz	eizh
hoeiz	eizh
eihdad	eizhteziad
eihdiat	eizhteziad
eizdezyeg	eizhteziek
eizdezyeg	eizhteziek
aneizved	eizhved
eihvet	eizhved
eisvet	eizhved
eizvedo	eizhved
aissite	eksita
eksperias	eksperias
exprimidiguez	eksprimidigezh
extrior	eksterior
exterior	eksterior
exterioramant	eksterioramant
Elamitet	Elamit
eleza	eleizha
electric	elektrik
Eleonora	Eleonora
eulfennoutan	elfenndan
elvennoutan	elfenndan
elfen	elfenndan
eltrisa	eltrisa
enememmelleus	emelloutemella
emmerret	emeret
emetiq	emetik
emgannet	emgannaemganni
aemganne	emgannaemganni
emganna	emgannaemganni
emganna	emgannaemganni
enf	e
enf	e
n	e
II	e
endalc'het	enderc'hel
indoarerh	endouarerezh
einebage	enebaj
einebage	enebaj
enebeg	enebek
enebiez	enebiezh
enebiez	enebiezh
enezenad	enezennad
enflammet	enflammet
engherz	engerzh
ingros	engroez
ingroez	engroez
ingroez	engroez
Eunningroezadud	engroez
euningroezadud	engroez
euningroeztud	engroez
engroes	engroez
ingrozet	engroezet
inclasquerion	enklasker
Encresi	enkrezi
aenkreze	enkrezi
Encresi	enkrezi
enkrezi	enkrezi
aenkrezjomp	enkrezi
d'nou	eno
d'ino	eno
d'inou	eno
d'nou	eno
d'ino	eno
in	eno
Aino	eno
aino	eno
aginou	eno
ino	eno
abenino	eno
betekeno	eno
dreeno	eno
setueno	eno
setueno	eno
wareno	eno
dreheno	eno
dreeno	eno
Dreeno	eno
inou	eno
in	eno
ainou	eno
Aino	eno
Vardroeno	eno
azohinou	eno
ynoed	enoeed
inoued	enoeet
inouet	enoeet
enouet	enoeet
inourabl	enorapl
enorapla	enorapl
insahet	ensac'ha
entanet	entanet
entanet	entanet
entanet	entanet
entanet	entanet
entanet	entanet
hentr	entre
entreprenance	entreprenas
Entronozvintin	entronoz
entronozda	entronoz
envoada	enwada
envoadet	enwadet
enwadet	enwadet
eonennet	eonennet
eonuz	eonus
houret	eoreteoriet
stiq	eostig
estig	eostig
eostik	eostig
eostig	eostig
Eaultourmantin	eoultourmantin
ivlneg	eoulennek
eolierez	eoulierezh
entez	er
er	er
er	er
Erec	Ereg
erezaz	ereziereza
erfont	erfont
Aketaou	ergentaou
Ergentaou	ergentaou
ergentaou	ergentaou
eridiguez	eridigezh
ermezidi	ermaeziad
Ermesiad	ermaeziad
erruet	erruet
essaou	esa
Hesqemer	eskemmez
eskamed	eskemmez
eskemed	eskemmez
esclavach	esklavaj
eskoptieg	eskoptiek
epinarz	espinard
esterloup	esterloup
estlamed	estlammet
estlamet	estlammet
estlammet	estlammet
estonapl	estonapl
estonaploc'h	estonapl
estounabl	estonapl
istre	estre
istre	estre
istrema	estre
estremded	estremded
estren	estren
estrewit	estrevit
estrevidoc'h	estrevit
etablisset	etablisa
etablisset	etablisa
etad	etad
Etew	etev
eteo	etev
riadeu	euriad
riadic	euriad
riad	euriad
Europead	Europead
Eurusamant	eruzamant
heurvez	eurvezh
Ez	euzh
euzi	euzhi
veleneq	evelhennik
evelennik	evelhennik
eveljust	eveljust
Evelkent	evelkentevelkent
evezdet	evezhded
evesdet	evezhded
evitdoare	evitdoare
Nacevitse	evitse
uloc'h	evlec'henn
envnglaz	evnglas
entouerDoue	evntouerDoue
Iya	eya
Es	ez
ez	ez
ec'h	ez
ezansoer	ezasouer
ezansouer	ezasouer
ezommus	ezhommus
fablen	fablenn
fablenn	fablenn
fablennou	fablenn
fabourzyo	fabourzh
fabric	fabrik
obetfach	fach
doh	fach
evagan	fagani
fagoder	fagoder
faillet	failhet
Falc'hadec	falc'hadeg
falamzer	fallamzer
fallgaloun	fallgalon
fallgalon	fallgalon
fallgaloun	fallgalon
falobr	fallober
falvin	fallvin
falvrud	fallvrud
falskredennou	falskredenn
falscredennou	falskredenn
falskredennou	falskredenn
falskredenn	falskredenn
testeni	falstesteni
Falhvarchecheu	falsvarch
Filsierauten	falzaotenn
famin	famin
famin	famin
famina	famina
Fainch	Fach
Fanch	Fach
Fanch	Fach
fanfarluchou	fafarlucho
fanfarluchou	fafarlucho
fantaziec	fantaziek
fausoni	faosoni
faussonie	faosoni
faussony	faosoni
faosoniou	faosoni
fahuen	faouenn
Fard	fard
Fardel	fardell
faro	faro
faro	faro
farouel	farouell
Farcerez	farserezh
farserez	farserezh
farserez	farserezh
farserez	farserezh
faceaface	fashafas
fassafass	fashafas
fasafas	fashafas
fassated	fasataet
fateit	fasataet
Faset	faset
fatet	fatet
fatigus	fatikus
fatiquus	fatikus
faveri	favori
Fea	fea
feal	feal
feal	feal
c'hwederc'hwedez	federell
feillad	feilhad
feilhennoc	feilhennek
feilletez	feilhetez
feizd'amdistac	feizda'mdistag
feizd'amdouchic	feizda'mdouchig
afalledezo	fellelfelloutfallout
nafellketd'ehan	fellelfelloutfallout
afalledezhan	fellelfelloutfallout
felloutdehan	fellelfelloutfallout
afelld'ehoc'h	fellelfelloutfallout
mafelled'he	fellelfelloutfallout
felleni	felleni
feultr	feltr
feltret	feltret
famelon	femelenn
vumelen	femelenn
fentajo	fentado
fermamant	fermamant
fermier	fermier
fermoni	fermoni
feura	feurafeuria
Fic'h	fic'h
fik	fic'h
fichelladou	fichellad
Fic'hellat	fic'hellat
fic'hellerez	fic'hellerezh
fic'hellerez	fic'hellerezh
Fic'hellerez	fic'hellerezh
fidandoustac'h	fidamdoustac'h
fid'andero	fidanderv
fidazomen	fidazomen
fidelamant	fidelamant
fidlit	fidelite
fidlit	fidelite
fidouac'h	fidouac'h
fidoustac'h	fidoustac'h
fidoustic	fidoustik
Figuzaat	figusaat
filipedlann	filiplann
filout	filout
filosofe	filozof
filosofed	filozof
filozofed	filozof
filosof	filozof
filosofi	filozofi
filosofi	filozofi
filozofi	filozofi
philozophi	filozofi
fimel	fimel
finfonz	finfos
finissa	finisa
finvad	finvad
finvadenn	fivadenn
finvaden	fivadenn
fionnage	fionaj
nafionquet	fioni
flac'hou	flac'h
flaio	flac'h
flao	flac'h
flac'hou	flac'h
fleriadennou	flaeriadenn
flaeria	flaeriaflaerii
flagorni	flagorniflagornal
flambeu	flambev
flambieu	flambev
flambyeu	flambev
flamboz	flamboz
flamder	flammder
Vlandrinen	flandrinenn
flepperez	flaperezh
flastr	flastr
flastret	flastret
flatat	flatealflateat
flatrerezed	flatrerez
flat	flatrerezh
aflao	flav
aflao	flav
fled	fled
flemmr	flemmaer
flemata	flemmata
flemmer	flemmer
fleur	fleur
fleurachi	fleuraji
fleuraziou	fleurajo
fleurenned	fleurennet
fleureji	fleureuji
fleureuji	fleureuji
fleuven	fleuven
flip	flip
flipad	flipaflipatflipi
flipa	flipaflipatflipi
flipa	flipaflipatflipi
flipa	flipaflipatflipi
flipat	flipaflipatflipi
vlistreresdour	flistrerezdour
fraudage	flodaj
frauder	floder
eurvagfroderez	floder
flauderezou	floderezh
flauderez	floderezh
froderez	floderezh
flojeal	flojeal
flojeal	flojeal
flouradergalon	flouraat
vlutach	flutaj
voeltrach	foeltraj
foenmelchen	foennmelchon
foenneyermed	foennegved
foennen	foennenn
foenwour	foevour
fonhour	foevour
fonhur	foevour
fouetedrantel	foetedrantellfoetedrantenn
foetfak	foetfank
foettryen	foeter
Foeterezikarbelek	foeterezigarbeleg
foetet	foetet
follez	follez
fondaision	fondezonfondezion
fondzon	fondezonfondezion
fondzon	fondezonfondezion
fondzon	fondezonfondezion
fonnable	fonnapl
fonnabl	fonnapl
fonnet	fonni
efonnou	fonni
renchoufonsier	fosier
fontbadisiant	fontbadeziant
fondai	fontafonti
efond	fontafonti
fontan	fontafonti
Foran	foran
Beza	foran
foran	foran
war	foran
foran	foran
foran	foran
gantho	foran
foran	foran
adreuzforhan	foran
forban	forbann
forbanat	forbannat
forbanet	forbannet
forbanet	forbannet
forbanet	forbannet
forc'hetavorc'heta	forc'hata
forc'hata	forc'hata
Forester	forester
form	form
form	form
formidabl	formidapl
arFourn	Forn
forzedigez	forzhidigezh
forzediguezou	forzhidigezh
fossel	fosell
foubenn	foubenn
foubenna	foubenna
foudralis	foudralis
c'hwezhmouezh	fouezh
foug	foug
Foug	foug
fougueus	fouges
fouildret	fouilhdret
fouin	fouin
foulans	foulas
Foulc'h	foulc'h
foulet	foulet
foulet	foulet
foulet	foulet
c'houezarfoulet	foulet
foulgonze	foulgomz
foultra	foultra
d'erfourch	fourch
Fourchad	fourchad
fourgazet	fourgaset
afourga	fourgasi
Nefourgazetquet	fourgasi
fourgaz	fourgasi
fourradou	fourrad
fourrad	fourrad
frac	frag
frak	frag
frak	frak
Franseza	Fraseza
MariFranseza	Fraseza
fraodu	fravdu
freok	freok
freozrup	freoz
fredtou	fret
freuza	freuzafreuziatfreuzi
freuzo	freuzafreuziatfreuzi
freuza	freuzafreuziatfreuzi
freuzellou	freuzell
frigaset	frigaset
frikerezbolc'h	frikerezhbolc'h
fringellat	fringellat
fringolou	fringol
frippon	fripon
fripouned	fripon
friponage	friponaj
fripponniri	friponiri
fritryen	friter
fourmus	fromus
frondage	frondaj
frounellou	fronell
fronellou	fronell
fronellou	fronell
frounlleryen	froneller
Froudenna	froudenna
froudennek	froudennek
frouezmir	frouezhmir
frehenneu	frouezhenn
frouesierez	frouezherezfrouezhierez
frhettoh	frouezhet
Fromm	froum
frugpenn	frugpenn
fulec'hen	fulac'henn
fuladen	fuladenn
fumi	fumafumifumal
fumi	fumafumifumal
fumi	fumafumifumal
fumi	fumafumifumal
furch	furch
oberarfurch	furch
ober	furch
oberfurch	furch
furol	furol
Fustmust	fustmust
futetoc'h	futet
futet	futet
fuzillet	fuzuilha
fuzilio	fuzuilha
fusillenneu	fuzuilhenn
fuzulien	fuzuilhenn
gachik	gachig
ed	gagez
caignus	gagnus
galantage	galantaj
galantereah	galanterezh
galetten	galetenn
ed	galez
Galilea	Galilea
Gallc	galleg
gallek	galleg
gallek	galleg
Galvidigez	galvidigezh
c'han	gan
ganaza	ganaza
Gaoliad	gaoliad
ac'haoliad	gaoliad
ac'haoliet	gaoliad
gaolodou	gaolod
gaoiec	gaouiek
Gaouierez	gaouierezh
c'haoui	gaoui
gardian	gardian
garinebet	garenebi
garnabet	garenebi
garet	garet
garzadou	garzhadgarzhiad
eurc'harziat	garzhadgarzhiad
garjeta	garzhata
gaffrgoez	gavrouez
gchogchobihan	gcho
guedougou	gedig
gedikou	gedig
Guedour	gedour
guedouryen	gedour
guelbrun	gellbrun
c'hinaougui	genaouegigenaouegal
ginaouegioc'h	genaouegigenaouegal
c'hinaouegi	genaouegigenaouegal
genoukamm	genokamm
Germanet	German
germes	germes
guetezou	get
Gude	get
naguet	get
geuz	geuz
gevredihuel	gevreduhel
Georenn	gevrenn
ed	gidaz
nec'hidazer	gidazi
eginane	gidone
guignon	gignon
guinerez	ginerezh
guioc'hed	gioc'hkioc'h
Kioc'hvor	gioc'hmor
guittar	gitar
glac'har	glac'har
glanguen	glanwennglangen
gleumarhue	glaoumarv
Glaoar	glaouaerglaouer
Glaouaerglaouer	glaouaerglaouer
glaouaer	glaouaerglaouer
Glaouaerien	glaouaerglaouer
marc'hglaour	glaouaerglaouer
glaouennet	glaouennet
Glazkaol	glaskaol
Glazc'hoarzin	glasc'hoarzhin
glassi	glasi
hlasoni	glasoni
clazoni	glasoni
c'hlasvezi	glasvezi
ac'hlasvezas	glasvezi
glao	glav
glaw	glav
glaw	glav
gleu	glav
gleu	glav
glaoeier	glav
gloeier	glav
glaoyer	glav
Glu	glav
Goennglao	glav
Glaostok	glav
glasaoured	glazaour
Glazenn	glazenn
glazennek	glazennek
glazet	glazet
glazur	glazur
c'hlasvezi	glazvezi
Kleizdour	gleizdourgleizhdour
gleupach	gleupaj
glysenned	glizenn
glizen	glizhenngwlizhenn
glizennoufresq	glizhenngwlizhenn
Urc'hlizenn	glizhenngwlizhenn
glouhet	glizhetgwlizhet
glosussoh	gloazus
glosus	gloazus
glouistr	gloestr
gleuat	gloevaat
gloahuequan	gloevek
c'hloriuzded	gloriusted
gloriusted	gloriusted
Glout	glout
glozard	glozard
Glozard	glozard
goao	goaf
goaf	goaf
Goafergwafer	goafer
gon	gon
gouaad	goavad
goanvn	goavhav
obergoapoc'h	goap
goapeogeth	goap
ehragoap	goap
voaperez	goapaerezh
goapereah	goapaerezh
goaperez	goapaerezh
gobiuz	gobius
gobius	gobius
Godig	God
gaudissal	godisalgodisa
d'audissalar	godisalgodisa
godissogodisset	godisalgodisa
c'hodisal	godisalgodisa
gaudisseres	godiserez
godiserez	godiserez
Goden	goedenn
Goedenn	goedenn
leazgoueden	goedenn
Goedennek	goedennek
goet	goet
Goge	goge
c'hogeal	gogealgogeagogei
c'hogeal	gogealgogeagogei
gogeal	gogealgogeagogei
gogeet	gogealgogeagogei
gom	gom
Goneri	Goneri
gonvor	govor
gomor	govor
gomor	govor
Govorgor	govor
gr	govor
goprdevezouryen	goprdevezhour
gobdevezour	goprdevezhour
goradennouheol	goradennheol
goradennyir	goradennyer
arc'horaden	goradennyer
c'horerez	gorerez
goridik	goridik
goroadennou	goroadenn
Goroadenn	goroadenn
goroadenn	goroadenn
c'horoet	goroet
c'horre	gorre
gourre	gorre
tontd'argorre	gorre
oarourre	gorre
varc'horre	gorre
varc'horre	gorre
vargorre	gorre
gorreaoter	gorreaoter
c'horreDoue	gorreDoue
gorreKerne	GorreKernev
gouarnamant	gouarnamant
arc'houarnamant	gouarnamant
arc'houarnamant	gouarnamant
c'houarnamant	gouarnamant
goarnation	gouarnasion
hoarnation	gouarnasion
kigouarnour	gouarner
Godor	goudor
goudouer	goudor
goudouerou	goudor
goudor	goudor
Godoer	goudor
reigoudord'ign	goudor
goudor	goudor
goudouren	goudorenn
gouedi	gouedi
GouilMariacreisst	GouelMariaKreizEost
gouilMariaGuenholon	GouelMariaWengolo
gweleac'hiou	gouelec'h
goueleac'h	gouelec'h
gweledet	goueledet
aweledaz	goueledi
goueledi	goueledi
ouilereah	gouelerezh
ouilereah	gouelerezh
gouiliadeu	goueliad
Goeliadgoueliad	goueliad
urhouliaden	goueliadenn
urouilliaden	goueliadenn
ovoenni	gouenni
urhourem	gourem
c'houeria	goueria
gouive	gouez
gouiv	gouez
gouez	gouez
gouez	gouez
Goez	gouez
gouez	gouez
Hoadgoez	gouez
goez	gouez
oc'hgouez	gouez
goz	gouez
gou	gouez
gouez	gouez
gouez	gouez
gouihuan	gouez
gouivd	gouez
gouivd	gouez
gouiv	gouez
gouezarded	gouezard
goueziad	goueziad
arc'houezidi	goueziad
gouilhed	goulh
goujard	goujard
gouloucoar	goulaouenngoar
goulaouideiz	goulaouideiz
goulaouideiz	goulaouideiz
goulaouideiz	goulaouideiz
goulaouideiz	goulaouideiz
goularaat	goularaat
goulas	goulazh
gloahet	goulazhet
goulc'her	goulc'her
goulc'har	goulc'her
azelaouaz	goulenn
hepnagoulennnadiskenn	goulenn
hepgoulennadisken	goulenn
hepgoulennnadiskenn	goulenn
goulenn	goulenn
aroazhec'houlenn	goulenn
Gourlerc'higoulerc'hi	goulerc'higoulerc'hat
Gourlerc'her	goulerc'her
gourlosket	goulosket
gouloukoar	goulokoar
gourdajeneign	gourdajenni
gourdrouzou	gourdrouz
gourdrouzou	gourdrouz
oberda	gourdrouz
argourdrousarerdezhan	gourdrouz
gourdrouzereah	gourdrouzerezh
gourdrouzet	gourdrouzet
gouremou	gourem
gouremou	gourem
gourenesy	gourenez
agorgammou	gourgamm
korgamek	gourgammek
gouriz	gouriz
gourizou	gouriz
ahurlam	gourlamm
ahurlam	gourlamm
eurc'hourlonen	gourlenenn
gournei	gournatgourni
gournoset	gournosa
gourpositet	gourpozitet
gourzavet	goursavet
gourvamgoh	gourvammgozh
gourvezet	gourvezet
gourvezet	gourvezet
Gouriaw	gouryev
urhoust	goust
houst	goust
goustet	gousti
gourstreadou	goustraed
goutab	goutapl
gouzanveg	gouzavek
gousel	gouzer
gouzilh	gouzer
c'houzouga	gouzougalgouzouga
gradvad	gradvat
gradvad	gradvat
greadigez	graedigezh
graeoc	graeek
graoc	graeek
ragachatragachi	gragachatgragachi
gramherianed	grameliangramerian
grateit	grataet
grateit	grataet
Grefad	grefad
graamant	greiamant
grek	grek
gremenneg	gremennek
Gres	Gres
Grenroc'h	greunroc'h
greunadour	greunadergreunadour
c'hrenadourien	greunadergreunadour
greuned	greunietgreunet
grignoyadou	grignoliad
grilheddoar	grilhdouar
grillet	grilhet
grillet	grilhet
grilled	grilhet
grillet	grilhet
grime	grim
grimeu	grim
grim	grim
grimaseryen	grimaser
gimaus	grimasus
grizienngrizion	griziengrizion
grizienngrizion	griziengrizion
grizinkalgerzignkhal	grizinkal
grizinkalgerzignkhal	grizinkal
grizwenn	grizwenn
groc'hennet	groc'hennet
grognus	grognus
grondinougrondined	grondin
gronchet	grojet
gros	gros
gros	gros
guiffreu	guiffreu
voaderessa	gwaderesa
erhoederez	gwaderez
goaderezedmarc'h	gwaderezvarc'h
voacal	gwakal
gacolet	gwakolet
goalarnster	gwalarnster
holernihuel	gwalarnuhel
goalc'hkaloun	gwalc'hkalon
avoalc'hkaloun	gwalc'hkalon
qarr	gwalenngarr
gwalenngein	gwalenngein
ehoal	gwali
gwall	gwall
guall	gwall
oall	gwall
oall	gwall
gwel	gwall
gwell	gwall
gwal	gwall
gwall	gwall
gwallaelez	gwallael
guallElez	gwallael
goalllez	gwallael
oalalli	gwallali
ouallalli	gwallali
voallaviuz	gwallavius
goallbaea	gwallbaea
oualparlantont	gwallbarlanti
goalbedenneu	gwallbedenn
goalbeden	gwallbedenn
goualldenvalaat	gwalldevalaat
goalldrei	gwalldrei
Goalldroet	gwalldroet
aoualexempl	gwallegzampla
wellgann	gwallganna
gvoallgavet	gwallgavet
goalguemeret	gwallgemeret
goalguemret	gwallgemeret
goalgundu	gwallgundu
coalgundu	gwallgundu
coalgundu	gwallgundu
voalgundu	gwallgundu
goalgustum	gwallgustum
goalhent	gwallhent
goalisprit	gwallisprid
goalloberyou	gwallober
gwallberiou	gwallober
gwalloberiou	gwallober
goalloberou	gwallober
gwallober	gwallober
awallrebecher	gwallrebech
goallzamm	gwallsamma
goalskotganthan	gwallskei
nehoalsplannouquet	gwallsplanna
goalstad	gwallstad
gwallstad	gwallstad
goalstad	gwallstad
guallstad	gwallstad
avoalstag	gwallstaga
avoalstag	gwallstaga
avoallstourm	gwallstourm
goalusage	gwalluzaj
gouallvankout	gwallvankout
goalvlesset	gwallvlesa
wanderiou	gwander
gouander	gwander
gouanderiou	gwander
gwano	gwano
gwardoukear	gwardkr
goardianez	gwardianez
Goarger	gwareger
gwaremm	gwaremm
gwarm	gwaremm
arwarem	gwaremm
goarm	gwaremm
voarem	gwaremm
goaremmou	gwaremm
goaremm	gwaremm
urhoarem	gwaremm
ouaskella	gwaskella
ouaskellaz	gwaskella
goasketoc'h	gwasket
goasketoc'h	gwasket
gwaspell	gwaspell
gwastelled	gwastelli
wazpewaz	gwazhpewazh
Gwazennvor	gwazhennvorgwazhiennvor
arvoazennzour	gwazhennzourgwazhiennzourgwazhienndour
Gwazienn	gwazhienn
voaziet	gwazhienn
gut	gweet
gueet	gweet
gweliab	gwelapl
gelchet	gwelchet
gweletl	gweletaol
gwelead	gwelead
golead	gwelead
gwelead	gwelead
gwenanet	gwenaennet
guenel	gwennel
erhuignlen	gwennelenn
Arwennik	gwennig
arwenik	gwennig
gwenno	gwenno
guinaudren	gwenodenn
guenodennou	gwenodenn
gwenodenn	gwenodenn
Ervenojenn	gwenodenn
guinojennou	gwenodenn
guentachou	gwentajo
gouentrik	gwentrik
gwerc'h	gwerc'h
guerh	gwerc'h
guerc'hder	gwerc'hder
huerhedigueah	gwerc'hedigezh
guerniou	gwern
gwerseet	gwersaat
guerzer	gwerzher
gest	gwest
Goen	gwevn
Goenv	gwevn
gwevn	gwevn
gwezennvabu	gwezbabu
gwezbanan	gwezbanan
gwezkoton	gwezkoton
urwezennoranjes	gwezorajez
urhuenpalms	gwezpalmez
urvezenpalmez	gwezpalmez
gwezzedra	gwezsedra
urvezennad	gwezennad
urvezennad	gwezennad
Gweachavez	gwezhavegwezhavez
guiaderez	gwiaderez
viaderez	gwiaderez
aviade	gwiadi
eurwianen	gwianenn
gic'hat	gwic'hal
Gwic'hal	gwic'hal
guic'hal	gwic'hal
Gwic'hal	gwic'hal
guidreal	gwidreal
Gwidret	gwidreet
Tehuignoud'ein	gwignalgwigni
Gouigour	gwigour
guigour	gwigour
gwigour	gwigour
gwikefregwikhefre	gwikefre
gwikefregwikhefre	gwikefre
gwikefregwikhefre	gwikefre
gwikefregwikhefre	gwikefre
gwikhefrea	gwikefrea
villarennou	gwilerenn
guincousquet	gwinkousket
ginpalms	gwinpalmez
Guinal	Gwinal
guinal	gwinal
arvindask	gwindask
gniegour	gwiniegour
guinizspagn	gwinizhSpagn
Gunizegou	gwinizheg
gwinizgou	gwinizheg
kuneheg	gwinizheg
warwintel	gwintell
giveru	gwiver
guinver	gwiver
Guyon	Gwion
gwireed	gwiraat
guraouyen	gwiraer
arviraerien	gwiraer
viscadur	gwiskadur
gihue	gwiv
guiw	gwiv
guivt	gwiv
groahenn	gwrac'henn
groahlann	gwrac'hlann
vroegnewez	gwregnevez
arc'hreknevez	gwregnevez
gros	gwres
Grisienrz	gwriziennruz
Abascder	habaskter
enabascder	habaskter
abaster	habaskter
abasder	habaskter
hachu	hach
hadkeuneud	hadkeuneud
haderez	haderez
Haderez	haderez
Heal	hael
hlat	haelat
Aean	hage
Hagn	hage
hgean	hage
Aillonat	hailhonihailhonat
aillounat	hailhonihailhonat
aillounat	hailhonihailhonat
halabardenn	halabardenn
Hanteraff	hanterahanteri
gant	hanterahanteri
Hanterit	hanterahanteri
hanterc'hoaresed	hanterc'hoar
hantrhroeit	hanterc'hraet
hantrr	hantereur
neantervageket	hantervaga
antervreur	hantervreur
antervreur	hantervreur
anterc'hoad	hanterwad
hanterzillad	hanterzilhad
hantiss	hantiz
hantis	hantiz
hantisseu	hantiz
anouezen	havouezenn
anvoezen	havouezenn
anvoezen	havouezenn
harassal	harasal
ahardia	hardizhahardizhat
hardhad	hardizhahardizhat
enemhardizan	hardizhahardizhat
Harigella	harigella
arluetdiouthan	harluaharlui
harlueteuzhevro	harluaharlui
harluet	harluet
harluet	harluet
harluet	harluet
harpein	harpaharpi
harpaouc'h	harpaharpi
harpaouc'h	harpaharpi
arpompouz	harpaharpi
arpa	harpaharpi
harpein	harpaharpi
harpa	harpaharpi
harpanmac'hozni	harpaharpi
Umharpein	harpaharpi
N'enemharpitket	harpaharpi
enemharpa	harpaharpi
enemharpaz	harpaharpi
harz	harzh
hac'harzhasko	harzh
astafo	hastafo
hastek	hastek
havreqet	havrekaat
ebort	hebort
ebort	hebort
Hebreed	Hebre
hebreeg	hebreeg
hbrus	hebruz
hedamzer	hedamzer
hegach	hegaj
Hei	hei
hebrn	heizbrenn
ioheizeier	heizeg
jaden	hejadenn
helhus	helc'hus
elhus	helc'hus
helmourou	helmoer
emmolc'h	hemolc'h
henaourdet	henaourded
henmahen	hennmahenn
hent	hent
Hendge	hent
hentargroas	hent
deit	hent
ahoalhent	hent
hihasshhent	hent
nhntd'	hent
e	hent
enentze	hent
abephent	hent
abephent	hent
abephent	hent
Epebent	hent
Epebent	hent
epebhent	hent
epebent	hent
anhentse	hent
dal	hentdall
hentohouarn	henthouarn
henthouarn	henthouarn
hendhouarn	henthouarn
enchououarn	henthouarn
henthouarn	henthouarn
henthouarn	henthouarn
henthouarn	henthouarn
hentlouarn	hentlouarn
hentchoutro	henttro
ahentadeu	hentad
hentaploc'h	hentapl
hented	hented
hentedigez	hentidigezh
evelout	heveloutheveli
ahenvel	heveloutheveli
hrdein	herdi
hernach	hernaj
erder	herrder
herder	herrder
erder	herrder
erder	herrder
erder	herrder
erder	herrder
herret	herret
Herri	Herri
iskinet	heskinet
heurtellai	heurtelli
heuza	heuza
heuzaoeryen	heuzaouer
Everz	hewerzh
everz	hewerzh
enemhigolennaz	higolenna
hijendoa	hij
hilguennet	hilgennet
nhir	hir
hirisset	hiriset
Hirlachenn	hirlachenn
dreirnez	hirnezh
hirnes	hirnezh
hirnezet	hirnezhi
hirscouarnet	hirskouarnet
hirvelet	hirwelout
Hoata	Hoata
hoc'hunan	hoc'hunan
hoc'hunan	hoc'hunan
oc'hunan	hoc'hunan
houhunan	hoc'hunan
hoc'hunan	hoc'hunan
oc'hunan	hoc'hunan
Oc'haned	hoc'haned
Annoc'haned	hoc'haned
Holennenn	holenenn
Holenner	holener
ollbaduz	hollbadus
ollbaduz	hollbadus
ollbuissance	hollbuisas
olbuissance	hollbuisas
olbuissance	hollbuisas
ollpur	hollbur
ollc'halloudek	hollc'halloudeg
ollc'halloudeg	hollc'halloudeg
ollfur	hollfur
ollgarantezuz	hollgarantezus
ollzantel	hollsantel
hollzantel	hollsantel
ollvadelez	hollvadelezh
ollvadelezuz	hollvadelezhus
Ollvadelezuz	hollvadelezhus
ollvraz	hollvras
hopal	hopalhopahopi
hordosset	hordoset
horel	horell
horellryen	horeller
aorgell	horgellat
hortauzit	hortaozit
ehochellai	hoskellathoskelli
Hochellein	hoskellathoskelli
houarnourkezeg	houarnerkezeg
houbet	houbet
houlius	houlius
Houlouloup	houlouloup
Houp	houp
enhuad	huadi
hual	hual
Hualou	hual
huan	huanhue
huan	huanhue
heuen	huanhue
huan	huanhue
udurnez	hudurnezhhudurniezh
udurnez	hudurnezhhudurniezh
hug	hug
huguenaud	hugunot
huguenaud	hugunot
huhe	huhal
humenidiguez	humenidigezh
humplaat	humplaat
heunkreiste	hunkreisteiz
hunal	hunealhunei
hurlereah	hurlerezh
hibilldorn	ibildorn
ibila	ibila
Idoltriachidolitriach	idolatriajidolatriezh
Idolatriachidolatriach	idolatriajidolatriezh
idolatriaz	idolatriajidolatriezh
idolaerez	idolerezh
idolerez	idolerezh
Ieu	ieu
ifernek	ifernek
Jfourna	iforna
ignam	ignam
Hiltut	Ildud
bancqouilinocq	ilinek
imbecil	imbesil
humoret	imoret
impi	impi
importunance	importunas
importunance	importunas
importunance	importunas
importune	importuni
induljansed	induljaset
infinimant	infinimant
ifirm	ifirm
eneminformi	informi
ingaillerion	ingailher
inngal	ingal
ingalaningalou	ingal
ingal	ingal
ingalded	ingalded
igueded	inged
ingunage	ingennaj
ingrat	ingrad
inied	inia
injustamant	injustamant
hinkane	inkane
inclinationou	inklinasion
inclinationou	inklinasion
inclination	inklinasion
inclinationo	inklinasion
inclinationeu	inklinasion
incomprenabl	inkomprenapl
ignori	inorainori
ispired	inspirout
ispirout	inspirout
ainspiras	inspirout
instituet	institua
instrujet	instrujet
instrugein	instruji
'instrugein	instruji
instrujein	instruji
hint	int
Ind	int
ind	int
intancius	intasius
intanhuedigueah	intavedigezh
intanhuigueah	intavegezh
intanhuigeah	intavegezh
intanhuigeah	intavegezh
intennein	intenni
Iterdia	interdia
enterred	interet
interior	interior
Interioramant	interioramant
intr	intr
Intru	intru
intru	intru
inutilamant	inutilamant
ivanti	invanti
invoqui	invoki
yraignt	iragnenn
iragned	iragnenn
iragnen	iragnenn
Erigez	irinjez
irvinglas	irvinglas
Isfounchou	isfont
isfond	isfont
isfont	isfont
isfount	isfont
isfond	isfont
aissite	isita
isitet	isita
isch	iskuizh
scus	iskuz
Izkuz	iskuz
iskuz	iskuz
izlounkuz	islonkus
ispicer	ispiser
isplika	isplika
ispridet	ispridet
ispridettan	ispridet
ispridet	ispridet
istampieu	istampio
stribillet	istribilhet
itik	itik
itic	itik
itic	itik
itik	itik
itiket	itiket
itiked	itiket
tropik	itropik
itropeq	itropik
hitropic	itropik
Yvonig	Ivon
Yvonaik	Ivona
Isabel	Izabel
isela	izel
izela	izel
Izella	izel
gevredizel	izel
izellt	izelaat
Izlat	izelaat
aizellea	izelaat
izelaat	izelaat
humizellat	izelaat
enemizelaat	izelaat
enemizellaat	izelaat
enemizella	izelaat
izellit	izela
iselder	izelder
iselder	izelder
izelder	izelder
izilied	iziliet
jabodiqru	jabodruz
jagouill	jagouilh
Jakez	Jakez
baliSJakes	Jakez
jacqezen	jakezenn
jacobitd	jakobit
jambezenn	jamezenn
jamezen	jamezenn
janablou	janabl
Janseniach	jaseniezh
Jaodreer	jaodrer
jaugeaplan	jaojapl
jaujabl	jaojapl
jaugeabl	jaojapl
Japon	Japon
Japon	Japon
Japon	Japon
Japon	Japon
Jarnebie	jarnebie
jeant	jeant
jeant	jeant
jeinemant	jenamant
gnance	jenas
gnanus	jenasus
Gentiled	jentil
chentilaet	jentilaat
jentillt	jentilaat
Jeremias	Jeremiaz
Jermen	Jermen
erjessaze	jessa
jen	jeun
jirfollet	jirfollet
joaden	joaden
jostram	jostrom
chostrom	jostrom
joisein	jouisajouisi
journe	journe
Jud	Jude
juif	juif
jujet	juji
Juiliannen	Julianenn
arc'haban	kaban
cabanennou	kabanenn
gabanen	kabanenn
eurgabanen	kabanenn
gabeleskop	kabelleskob
urhabcr	kabeser
Kabestr	kabestr
cabouillet	kabouilhet
urhabuchon	kabuchon
gabuchon	kabuchon
gached	kached
gac'her	kac'her
kc'heler	kac'herer
o	kad
gadorabad	kadorabad
eurgadorbortez	kadorbortez
ergadorpredg	kadorbrezeg
urgadorpredg	kadorbrezeg
kadeurEskop	kadoreskob
Gadoreskob	kadoreskob
kadeurvarn	kadorvarn
kadorvarn	kadorvarn
hardenad	kadranad
gaerbez	kaerbezh
cahieret	kaieret
Kaladuria	kaladuria
kalaginnad	kalaginat
calbornyo	kalborn
kalledok	kaledek
kaleteit	kaletaet
kaleteri	kaleteri
kalfichadur	kalfichadur
arc'halir	kalir
galei	kalir
arc'halir	kalir
kaliriou	kalir
Qaliteou	kalite
galit	kalite
argalite	kalite
galite	kalite
kalkuli	kalkulakalkuli
calculi	kalkulakalkuli
calmed	kalmet
kalmouk	kalmouk
argalonlaz	kalonlazh
kalounadik	kalonadig
caloned	kalonet
caloned	kalonet
arc'halvar	kalvar
kelzen	kalzenn
calzenn	kalzenn
Kalzenn	kalzenn
marr	kalzennvarr
cambreuenhaul	kambroanheol
kamprouann	kambroanheol
Kamlez	Kamlez
Kamleziz	Kamleziz
kammbroud	kammbroud
gamdroyeu	kammdro
urgamdro	kammdro
camed	kammed
kammed	kammed
kammed	kammed
campinocha	kampinocha
kamz	kamz
argamz	kamz
argemz	kamz
ergenail	kanailh
arGananeen	Kananeenn
hellest	kanastr
eurganen	kanenn
eurganen	kanenn
eurganen	kanenn
arc'haniennou	kanienn
arganienn	kanienn
caniennou	kanienn
caniet	kaniet
caniet	kaniet
Canivel	Kanivel
cajolus	kajolus
kannadeg	kannadeg
kannadek	kannadeg
argannadenn	kannadenn
kannadenn	kannadenn
ganneresns	kannereznoz
Urhandatt	kantad
dagantifi	kantdifia
handeneu	kantenn
kannennad	kantennat
ergantit	kantite
cantoul	kantol
cantreryen	kantreer
kantvloasiad	kantvloaziat
goc'ha	kaoc'ha
kaolmeler	kaolmeler
kltal	kaolteal
Arc'haoleier	kaoleg
caousion	kaosion
kotet	kaotet
caoedadou	kaouedad
kaoudad	kaouedad
Kaouanen	kaouenenn
qaouennesed	kaouennez
argaouleden	kaouledenn
kaouledet	kaouledet
kaout	kaoutr
kaozeadennou	kaozeadenn
Caozeaden	kaozeadenn
gaozeadenn	kaozeadenn
Kap	kap
erhapitul	kapitul
argaptivet	kaptiv
argaptived	kaptiv
carabinennou	karabinenn
Karadek	karadek
caractrieu	karakter
caractr	karakter
garakter	karakter
kara	kara
karantek	karantek
carantenez	karantenez
eurgarantenez	karantenez
Vac'harantez	karantez
hec'harante	karantez
garantez	karantez
Karate	karantez
eurc'harate	karantez
c'harante	karantez
carapl	karapl
carabl	karapl
Carab	karapl
urhardel	kardell
kardel	kardell
kardelet	kardellet
urhardriad	kardeuriad
CardinalEscop	kardinaleskop
kared	karet
karg	karg
karg	karg
kargour	kargour
kargour	kargour
caritellou	karitell
karmelited	karmelited
carmelitezed	karmelitezed
karmelitezed	karmelitezed
carnet	karnet
karnet	karnet
carnet	karnet
carnet	karnet
Carnet	karnet
carnet	karnet
agarnie	karnia
butunkarrot	karot
karoulle	karoulle
Karoulle	karoulle
arc'hirriadan	karradan
karrarmaro	karrarmarv
KarrDavid	karrDavid
kirritan	karrtan
arc'hirritan	karrtan
eurc'harbount	karrbont
karrener	karrener
Arc'hartermestr	kartermestr
carvanadou	karvanad
Karvik	karvig
urhachemar	kasmare
urhachemar	kasmare
urc'hasq	kask
Kaskalat	kaskalat
argastell	kastell
eurc'hastelcre	kastellkrev
Kastellan	kastellan
argastidigez	kastidigezh
castis	kastiz
kastorin	kastorin
kasta	kastra
Catalog	katalog
agatar	katara
kataret	kataret
cathedral	katedral
kathedral	katedral
catekiza	katekizakatekizat
katekouyek	katekouilheg
Cathelin	Katelin
Cato	Katou
cava	kava
Arc'havalier	kavalier
arc'haveldiveza	kavelldiwezha
cavlet	kavellet
caffer	kaver
caz	kaz
okazarc'h	kazarc'henn
kazgleb	kazhgleb
qizyervor	kazhmor
Kazpin	kazhpin
cazout	kazoutkazet
negazanket	kazoutkazet
Arguedez	kedez
Qedez	kedez
arc'hedez	kedez
arc'hefelegaod	kefelegaod
keferet	keferet
kefiada	kefiada
kefiada	kefiada
gefia	kefia
geulaiein	kefleuei
c'hegilloutoull	kegeldoull
arc'hegit	kegid
kegit	kegid
keeluz	kehelus
keithakeitall	keithakeitall
caige	kej
kaijmeij	kejemesk
erhaijaj	kejaj
caijaj	kejaj
II	kel
A	kel
Urc'hehezlaour	kelaouer
Qellid	kellid
erhlid	kellid
kellid	kellid
kelokeloze	kelokelav
kelowech	kelokelav
kelteg	keltiekkeltek
arc'hemreg	kembraeg
kementral	kemendarallkementarall
kementral	kemendarallkementarall
qemenryenvor	kemenermor
kemenerienvor	kemenermor
eurgempenn	kempenn
eurgempen	kempenn
eurc'hempen	kempenn
gempennet	kempennet
genderf	kenderv
kendirvi	kenderv
kindirvi	kenderv
genedet	kenedet
qenesqep	keneskob
eurc'heneskob	keneskob
kenetrezomp	kenetre
qengavou	kengav
qenidervesedcomps	kenitervgompez
Kenclo	kenklav
kemseurtgant	kenseurt
gansortis	kenseurtiz
arc'henthed	kenthed
kentraouet	kentraouet
qennvilinou	kenvilin
Kryou	ker
kriomamm	krvamm
querheisquerhair	kerc'heiz
Eurgarkleiz	kerc'heiz
garc'heiz	kerc'heiz
argalc'hei	kerc'heiz
kerronnet	kerc'honet
guerea	kerea
ergurentage	kerentaj
argerentiach	kerentiaj
Kereourler	kereourlr
Kerezek	kerezeg
keriadenn	kriadenn
Kernu	KernevKerne
Kerne	KernevKerne
Kerne	KernevKerne
Kerne	KernevKerne
BroGerne	KernevKerne
Kernevihan	KernevKerne
kerniek	kerniek
kerteri	kerreri
kertrius	kerterius
Kerzevot	Kerzevod
arGuerzevot	Kerzevod
edkerzhin	kerzhinenn
keuneudtan	keuneudtan
keuneudtrouc'h	keuneudtroc'h
keuneudet	keuneudet
keuneuded	keuneudet
gairr	keur
arc'heuriou	keur
Keur	keur
keuren	keurenn
kaouz	keuz
qeuzeudiqt	keuzidikaet
keuiek	keuziek
Kevedkevet	keved
keveleriach	keveleriaj
qevendirvy	kevenderv
Quifniantesset	kevniantez
kefniatez	kevniantez
Kivor	kimor
eurc'himor	kimor
kikastenn	kigastenn
kigeret	kigeri
Kign	kign
Gignalar	kignarar
qignezegou	kignezeg
qignezenned	kignezenn
Kikoun	kikon
kiko	kikon
arc'hilcrog	kilkrog
kildroadur	kildroadur
Quilheryet	kilheri
Killeri	kilheri
arGuilly	Killi
kiljacha	kilsacha
kilvisiet	kilviziet
Arc'hinin	kinin
arc'hlinkerez	kinklerezh
arc'hinklerez	kinklerezh
kinklerez	kinklerezh
quiqlet	kinklet
kintret	kinklet
kesten	kistin
c'histin	kistin
kistenmoc'h	kistinmoc'h
arguistinecqqestenecq	kistineg
Ergestenen	kistinenn
kiza	kizakizi
Qiza	kizakizi
qiza	kizakizi
negizoket	kizakizi
glanvadurez	klavadurezh
klavt	klavaet
klanvaet	klavaet
clanveet	klavaet
eurc'hlanvour	klavour
arglanvourien	klavour
arc'hlanvour	klavour
Glaodina	Klaodina
claoustreerien	klaoustreer
Klaoustreer	klaoustreer
glapezennou	klapezenn
Klara	Klara
Klask	klask
Clasc	klask
oberklask	klask
nelakent	klask
klah	klask
emaoc'heklaskeuz	klask
glaskerioneur	klaskeraour
arc'hlaskerienhoboud	klaskerevoued
eurc'hlec'h	klec'h
arc'hleder	kleder
grezennet	kleizhennet
clemuchat	klemmuskat
Klemvan	klemmvan
klenkwarnhan	klenk
clenq	klenk
Clet	Klet
kleuieres	kleuzierezh
clicqedou	kliked
kliked	kliked
arC'hloastrPlourin	KloastrPlourin
kloc'hgalf	kloc'hgalv
kloc'hgalf	kloc'hgalv
clehirdiscoharne	kloc'hskouarn
c'hlodad	klodad
Glormeneh	kloervenec'h
klor	klor
kloret	kloret
klostret	klostret
argluven	klufan
eurwabrenen	koabrenenn
encoach	koach
arc'hoadalc'huez	koadalc'hwez
koadelv	koadelv
koedhaleg	koadhaleg
koadhallek	koadhaleg
koatkreo	koadkrao
koedkroez	koadkroaz
koattan	koadtan
koadesk	koadesk
coagri	koaga
goanan	koaniakoagnikoana
mavezokoanietd'in	koaniakoagnikoana
koaniet	koaniakoagnikoana
Koanhoc'ha	koanoc'ha
koant	koant
koant	koant
koant	koant
koant	koant
koant	koant
Koantoc'hzo	koant
coantized	koantiz
goantiz	koantiz
Koarell	koarell
Coataat	koataat
Koataer	koataer
koateet	koataet
Coateat	koataet
Koaza	koazhakoazhi
makoahe	koazhakoazhi
koac'ha	koazhakoazhi
goaza	koazhakoazhi
KochVara	kochvara
hochon	kochon
kochonnet	kochon
c'hochon	kochon
coc'hennet	koc'hennet
coc'hennet	koc'hennet
coc'hennet	koc'hennet
god	kod
erhogui	koegi
eurc'hofstam	kofstamm
kovellek	kofelleg
kovellek	kofellek
Kofignon	kofignon
konfilis	kofilis
Kofilis	kofilis
koka	kogakogi
kokanan	kokanan
avalokoko	koko
Eurgokoen	kokoenn
c'hokoen	kokoenn
arc'hokombr	kokombr
cohle	kole
cohle	kole
Cozle	kole
cozleou	kole
kouhlaieu	kole
gouhlaitarw	koletarv
eurc'holetaro	koletarv
kolin	kolen
Kolin	kolen
arc'holera	kolera
kolera	kolera
arc'holera	kolera
arc'holera	kolera
kollout	koll
o	koll
kollou	koll
col	koll
wargoll	koll
kollet	koll
kol	koll
gollont	koll
humgollqit	koll
Eurc'hollpenn	kollpenn
urc'hollad	kollad
eurc'hollad	kollad
arC'houmblidou	komblido
urc'hombout	kombod
comboujou	kombod
cambout	kombod
kombot	kombod
erc'hombod	kombod
erc'hombot	kombod
kombod	kombod
comidyaned	komedian
arc'hommer	komers
Coummannaiz	Kommannaiz
commotoc'h	komod
goumpaignunezou	kompagnunezh
kompagnunez	kompagnunezh
koumpagnunez	kompagnunezh
obercompagnunezdezhan	kompagnunezh
oberkompagnunezd'ezhan	kompagnunezh
comparabl	komparapl
agompetaz	kompeta
agompetezeuz	kompeta
kompez	kompez
azokompez	kompez
kompez	kompez
koumpez	kompez
Comps	kompez
giniterfgompes	kompez
ezay	kompez
c'hompez	kompez
compesennadou	kompezennad
compli	kompli
Complidou	komplido
eurgompord	komport
c'homport	komport
enemgomporti	komporti
komprenet	komprenet
gomzen	komzenn
Conan	Konan
konferansi	koferasi
konfitur	kofitur
considerable	kosiderapl
Konsil	kosil
consolus	kosolus
consoluz	kosolus
consolusset	kosolus
consoluz	kosolus
consortizou	konsortiz
Constitut	kostitut
M'arconsultomp	konsulti
kont	kont
contadello	kontadell
contadellou	kontadell
eurgontadel	kontadell
contadellou	kontadell
countantamachou	kontantamant
eurgotelbif	kontellbif
kontrerolli	kontrerolli
controunet	kontronet
kontronet	kontronet
Kotroni	kontroni
kounvenout	kovenout
surezconvers	kovers
seurezedkonvers	kovers
o	kop
Corbiner	korbiner
qordennad	kordennad
Agordennadou	kordennad
agordennadou	kordennad
cordennet	kordennet
agordigelle	kordigella
urhordon	kordon
corcqed	kork
Gorlei	Korlei
Qorn	korn
pesqedqorn	korn
erc'hornpleg	kornpleg
erc'hornpleg	kornpleg
arc'hournaouok	kornaoueg
cornouec	kornaoueg
c'hournaouog	kornaoueg
Corniec	korniek
kornouriez	kornouriez
Kornzigor	kornzigor
Corobel	korobell
corollers	korollerez
urgrollers	korollerez
ergrollers	korollerez
'rC'horporal	korporal
eurc'horporal	korporal
corred	korr
arc'horred	korr
Korr	korr
koreo	korreenn
goreo	korreenn
koreenno	korreenn
Corrigantt	korrigan
andtt	korrigan
korvenn	korvenn
gorzenna	korzennakorzenni
korzennek	korzennek
okos	kosenn
Kost	kost
gostou	kosto
koto	kotenn
eurc'houplad	koublad
coublad	koublad
coublad	koublad
eurc'houblad	koublad
Koublad	koublad
arc'houblad	koublad
Koublerlevriou	koublerlevrio
kouetis	kouetiz
arc'hrouffograou	koufrograo
kougouleet	kougoulaat
gouignbzel	kouignveuzel
coulined	koulin
ergoulin	koulin
Koulinez	koulinez
klomet	koulmet
h'lommer	koulomer
Betzokoulz	koulz
kours	koulz
debepkourz	koulz
pedagouls	koulz
koulzovije	koulz
agourseu	koulz
comanadeost	koumananteost
arc'hoummoumor	koummmor
Korronkennouadarz	kouronkadennkoronkadenn
kourtaj	kourtaj
gouska	kouskaez
couskhean	kouskehan
arc'houskmintin	kouskmintin
eurgouskaden	kouskadenn
kousket	kousketkouski
kousket	kousketkouski
gousquein	kousketkouski
goustus	koustus
cousemennet	kouzoumenni
couzoumenna	kouzoumenni
couzoumenni	kouzoumenni
arC'hozVarc'had	KozhVarc'had
kozviret	kozhviret
chomdagoza	kozhakozhi
ergouhlammen	kozhlammenn
krabinad	krabinat
warhegrabosou	kraboso
krapoesmitaou	krampouezhmitaou
urc'hran	kran
crainchryen	kracher
crainchourou	krachouer
arc'hraondero	kraoderv
kraounfao	kraofaou
kraoennfaou	kraofaou
vvin	kraoennvevin
Crapat	krapad
kraperigargwez	kraperiggwezkraperigargwez
Krapinella	krapinella
crapisent	krapisa
grasedigueah	krasedigezh
eurc'hravasdoug	kravazhdoug
gravazellek	kravazhellek
Krazo	krazo
cret	kreaat
krec'hillek	krec'hilhek
kryetkrhet	krec'hilhet
crihanen	kreienenn
eurgrivinenn	kreienenn
crehenet	kreienet
kreizanderw	kreizenderv
arc'hrenalter	krenalter
arc'hrenizili	krenizili
argrenedeg	krenedeg
grennegellek	krenegellek
krennakrenn	krennhakrenn
kemer	krev
warub	krev
grnvan	krenvan
argrenvan	krenvan
krenvan	krenvan
krevasenn	kreoasenn
cresserelle	kreserel
knevyet	krevia
grezzier	krezier
Kribellgar	kribellc'harkribellarc'har
Urgribieres	kribierez
ribisatkrabisat	kribisat
kriellek	kriellek
arc'hrignereskern	krignereskern
krim	krim
kriphakrap	kriphakrap
gripissa	kripisa
agripisse	kripisa
crisset	kriset
Crisset	kriset
gristenach	kristenaj
argristenach	kristenaj
grecheneah	kristenezh
rgrechneah	kristenezh
krivinet	krivinet
ergroez	kroaz
hentargroas	kroaz
sinancroas	kroaz
arc'hroaziou	kroaz
arc'hroaziou	kroaz
kaoutkroaz	kroaz
Kroaz	kroaz
arGroaz	kroaz
argroaz	kroaz
Tenncroaz	kroaz
chapelkroaz	kroaz
chapelioukroaz	kroaz
OKroaz	kroaz
groasdor	kroazdor
KroazDoue	kroazDoue
creyeryod	krogyod
grogioud	krogyod
Krogennperlez	krogennberlez
Krogheren	kroger
hezibr	krommellenndibr
grostenn	krostenn
krot	krot
croten	krotenn
krouaj	krouajkroueaj
erhrouage	krouajkroueaj
grouation	krouasion
Croudigez	krouidigezh
crouidigez	krouidigezh
crouis	krouis
crouis	krouis
krouis	krouis
crouiset	krouizet
arc'hroup	kroup
urgrousten	kroustenn
kroza	krozalkroza
crozal	krozalkroza
krozal	krozalkroza
croza	krozalkroza
krozal	krozalkroza
crozet	krozalkroza
agroze	krozalkroza
krzal	krozalkroza
Crughellmerien	krugellverien
c'hruguelverrien	krugellverien
Grucefiereah	krusifierezh
Tremenkuhaka	kuhaka
tremenkuhaka	kuhaka
kuchennek	kuchennek
kouita	kuita
Kuitouz	kuitouz
culei	kulakuli
cuylatouryen	kulator
gulator	kulator
culatour	kulator
c'hulator	kulator
urguemunaut	kumunaote
Kuneet	kuvaet
kupennek	kupennek
eurgur	kur
Kur	kur
Gouronnereah	kurunerezh
gurunus	kurunus
cutuillet	kutuilhet
cutuillet	kutuilhet
cuzloar	kuzhloar
kuznoz	kuzhnoz
kusmudika	kuzhmuzika
labaskenned	labaskenn
labaskenn	labaskenn
Labaskenn	labaskenn
labenna	labenna
labenna	labenna
Labennalabennat	labenna
labourred	labourret
labousedmor	labousmor
labousedmor	labousmor
laboussigarc'hoad	labousigarc'hoad
labousikhorZalver	labousighorSalver
lachentez	lachentez
lachentes	lachentez
ler	laer
laeroun	laer
laer	laer
laervar	laer
drlair	laer
laeronmor	laermor
lsa	laesha
leazgoueden	laezhgoedenn
leski	laezhki
leazmager	laezhmager
lzpeket	laezhpeget
leazrez	laezherezh
laour	laiour
lala	lalla
Lambader	Lambader
Lambader	Lambader
Lambader	Lambader
lambrissadur	lambrisadur
areazlammchoukhebenn	lammchoukebenn
Lammout	lammatlammetlammoutlammilampatlampout
lampout	lammatlammetlammoutlammilampatlampout
Lammeresicg	lammerez
lammerigued	lammerig
varstokhelanchen	lachenn
hedholanchen	lachenn
edhelanchen	lachenn
lanchennyen	lachenneg
Ladrea	landrealandreat
langagereah	langajerezh
caoutholank	lank
caoutholank	lank
Lanevez	Lannevez
las	las
lanfaz	lavrez
Loranz	Laoras
Lauranz	Laoras
IannalLorans	Laoras
Laou	Laou
laouek	laoueg
laouek	laoueg
laouennidiguez	laouenidigezh
laouenedigez	laouenidigezh
laouenedigez	laouenidigezh
laouenidigez	laouenidigezh
Laouik	Laouig
lappadennou	lapadenn
lardec	lardek
lardous	lardous
largantus	largentezus
largantus	largentezus
lardkuill	lartkuilh
Lardtoas	larttoaz
laskroug	laskroug
lastezennet	lastezenni
lastezenni	lastezenni
lastrussoc'h	lastrus
lastruz	lastrus
lavachen	lavachen
lardislar	lavardislavar
lavarer	lavarer
lac'h	lazh
lac'hadeier	lazhadeg
Lasers	lazherez
lazidigesiou	lazhidigezh
leaz	leaz
lec'hiennou	lec'hienn
lec'hiennou	lec'hienn
lec'hiennou	lec'hienn
lc'hlistri	lec'hlistri
lic'hiduz	lec'hidus
led	led
ledanded	ledanded
ledanded	ledanded
ledanded	ledanded
ledandd	ledanded
ledanded	ledanded
let	leet
Legestr	legestr
leinouryen	leiner
leizkof	leizhkof
leizkof	leizhkof
lemmus	lemmus
lennu	lenn
Lenn	lenn
lennou	lenn
Lennou	lenn
lenn	lenn
lenn	lenn
Lenndor	lenndour
lentidigez	lentidigezh
Lentuz	lentus
lenvforz	levforzh
Leok	leog
lozenni	leozennaleozenni
lpre	lepr
lprus	lepruz
lerc'hlerc'h	lerc'hlerc'h
lisquidussa	leskidus
listriavrezel	lestrbrezel
listribrezel	lestrbrezel
lestrokeginlistrikegin	lestrkegin
lestrreder	lestrreder
Letchi	letchi
letonenn	letonenn
letonen	letonenn
letonenn	letonenn
lettrenneu	letrenn
Lettrad	letrenn
leuemor	leuemor
laieutarw	leuetarv
Luguen	leuegen
leunchec	leunchek
leunchec	leunchek
leunchek	leunchek
lanfoet	leunfoet
leunc'hoad	leunwad
leunc'hoad	leunwad
laieuaj	leuoeaj
leuryouqarr	leurgarr
leurzy	leurzi
leurzi	leurzi
leurzi	leurzi
leurzi	leurzi
leuren	leurenn
Leurenn	leurenn
leveoufound	levefont
levenedigez	levenedigezh
leveourien	leveour
leveour	leveour
livier	levier
levitez	levitez
levrdourn	levrdorn
livrour	levrer
levryadou	levriad
leziobarnlezvarnio	lezvarn
lezvarn	lezvarn
lesvarn	lezvarn
lezvarn	lezvarn
leze	leze
lesverc'hed	lezverc'h
liammet	liammet
liant	liant
liant	liant
Liasennad	liasennad
liban	liban
Libell	libell
libertin	libertin
libouz	liboust
liboust	liboust
liboust	liboust
liboustec	liboustek
liboustren	liboustenn
librance	libras
librance	libras
licheryou	licheri
lichichen	lichichen
liened	lienet
Lietenn	lietenn
lijar	lijer
liqes	likes
Liket	liket
Liketa	liketa
likez	likez
limage	limaj
limage	limaj
limage	limaj
limajeu	limaj
limet	limet
limonad	limonad
linadur	linadur
Linegez	linegez
linennet	linennet
Licherieuennoter	liselaoter
linserauter	liselaoter
linceilliou	liselvoan
alintraz	lintralintri
lintrourou	lintrouer
lvaden	livadenn
livaden	livadenn
livaden	livadenn
livach	livaj
liorzadou	liorzhad
liphevanne	lipevanne
lipad	lipad
lipenhalapen	lipennhalapenn
lipet	lipet
lipet	lipet
lipet	lipet
lipousiez	lipouziezh
Listren	listenn
livna	livna
livrisa	livrizh
lizenned	lizennet
lized	lizet
lizet	lizet
lizerekeet	lizherekaat
Lizerennou	lizherenn
lizerennou	lizherenn
loaioraned	loaraned
Lodennek	lodennek
lodennek	lodennek
lodenneker	lodennek
loegach	loegaj
LoisMari	Loeiz
loenedsamm	loensamm
loeinsam	loensamm
loensamm	loensamm
lojamanchou	lojamant
lokansuz	lokasus
Londrez	Londrez
lonchezrantel	lonkedrantell
lounkerez	lonkerezh
lonkerez	lonkerezh
lonkrez	lonkerezh
lonkereh	lonkerezh
lokeres	lonkerezh
Lopreden	Lopreden
lorb	lorb
lorbour	lorber
lorber	lorber
lorbour	lorber
lorberion	lorber
lorbour	lorber
lorbr	lorber
lorbour	lorber
boutlorbeta	lorbet
lorhet	lorc'halorc'hi
lorhein	lorc'halorc'hi
lorhein	lorc'halorc'hi
lorh	lorc'halorc'hi
lorchennek	lorchennek
lor	lore
lore	lore
lorgnek	lorgnek
lorvez	lorwez
lorvez	lorwez
loskus	loskus
loskus	loskus
loskus	loskus
lostarbleiz	lostarbleiz
LstKi	lostki
losthed	losthed
humlotias	lotia
louadesed	louadez
loadet	louadi
louan	louan
louaret	louaret
loudour	loudour
lucuen	louezaenn
louis	louiz
loukes	loukes
Loupenn	loupenn
perlez	loupenn
lousnach	lousnaj
lousoni	lousoni
lousoni	lousoni
louzaouat	louzaouad
Louzaouenallivrien	louzaouennalliverion
Louzaouenarberralan	louzaouennarverranal
LouzaouensantBnad	louzaouennsantBenead
louzerez	louzerezh
lovradur	lovradur
loreiloirei	lovralovri
lovrereah	lovrerezh
lovrereah	lovrerezh
lubaned	luban
luban	luban
lucha	lucha
lucha	lucha
aluche	lucha
ludufin	ludufin
ludusitr	ludusitrludusit
Reilufrda	lufr
rei	lufr
I	lug
ligernage	lugernaj
luhrieu	luher
lumier	lumier
luniou	Lun
lunedennou	lunedenn
lurellou	lurell
lussird	lusier
lusquemanteu	luskamant
Lusquemanteu	luskamant
lastreg	lustrugenn
lutina	lutina
loui	luz
luza	luza
luyanz	luzias
lurius	luzius
Mac'h	mac'h
maharvah	mac'hrvac'h
mac'hagnou	mac'hagn
mac'het	mac'hamac'hi
vachinaj	machinaj
mac'houm	mac'hom
mahomryen	mac'homer
mahet	mac'het
mahet	mac'het
mahet	mac'het
mahet	mac'het
mahet	mac'het
urvadam	madam
Madianited	Madianit
meanbenerez	maenbenerezh
meanfons	maenfos
meanglan	maenglan
meingriz	maengris
meanhugolin	maenhigolenn
Meingailhes	maenkailhez
meancorn	maenkorn
minkrapoas	maenkrampouezh
meanaoled	maenoaled
meanoaled	maenoaled
meanpont	maenpont
menpost	maenpost
meinpoez	maenpouez
meinstanq	maenstank
meinduf	maentuf
eurvesaeres	maesaerez
urvesaeres	maesaerez
gas	maez
gas	maez
davz	maez
ezaer'maeza	maez
magegorf	magegorf
magasinet	magazenna
Magazenna	magazenna
vagajenna	magazenna
Magnez	magnez
Maillur	mailhur
vaillurenna	mailhurenna
mailluret	mailhuret
mailluret	mailhuret
arVakabeed	Makabe
Mleeu	mal
malac'h	malac'h
valadecg	maladeg
maladennou	maladenn
malman	malamant
malevennet	malevennet
malagrs	malgras
malgrce	malgras
malgrce	malgras
malgrce	malgras
valvennigouDoue	malvennDoue
arvambarrez	mammbarrez
mamgar	mammgaer
ervamgouh	mammgozh
mamoukoz	mammgozh
arvamgoz	mammgozh
mammoukoz	mammgozh
eurvammgoz	mammgozh
vammmager	mammvager
arvamc'hrizien	mammwrizienn
urvamenbihue	mammennvev
arvenac'hbeleien	manac'hbeleg
mandogued	mandog
mandragore	mandragor
maneur	maneur
manioc	maniok
manjkaro	majkaro
vann	mann
mann	mann
mannerbet	mann
enepmann	mann
mann	mann
man	mann
man	mann
mane	mann
Mann	mann
menthe	mant
mantal	mantal
Modez	Maodez
Maotvelen	maotvelen
maotvelen	maotvelen
varcan	marc'hkav(o)
marc'hkavo	marc'hkav(o)
marc'hr	marc'haer
marc'hglaour	marc'hglaouaer
marc'hkulier	marc'hkulier
hevarc'hlimon	marc'hlimon
marc'hjervich	marc'hservij
marc'htaul	marc'htaol
marc'hitiout	marc'hyod
marc'hed	marc'het
mardandoustik	mardandoustik
Mardoust	mardoust
Mardoustac'h	mardoustac'h
Mardozi	mardozi
margaloneg	margalonek
margaloned	margalonet
margalonet	margalonet
evarikleze	marikleza
margeu	marko
margeu	marko
Grizilh	markouilh
mournaounet	marnaonet
marnec'het	marnec'het
maroni	maroni
maltred	mart
maltre	mart
Maltr	mart
varvailh	marvailh
eurmarvaillou	marvailh
marvaillou	marvailh
marvaill	marvailh
marvail	marvailh
Marvailh	marvailh
marveillus	marvailhus
masmean	masmaen
machepain	masapan
manjpain	masapan
masclet	masklet
vastikant	mastika
matezagampr	matezhagambr
Matiaz	Matiaz
Mazeu	mazeu
vea	mea
medet	medet
meudeusinaj	medisinaj
midita	medita
vidita	medita
vedita	medita
medita	medita
mega	mega
meget	mega
ed	megel
meillmein	meilhmaen
meinadurez	meinadurezh
meiz	meizmez
nedevezmeizeuz	meizmez
mekanik	mekanik
arVelandinen	melandinenn
melchen	melchon
melchen	melchon
velfet	melc'hwed
melc'hod	melc'hwed
melfed	melc'hwed
ervlen	melenn
melenog	melenog
melenok	melenog
melenuz	melenus
melconiet	melkoniet
melconiet	melkoniet
melconied	melkoniet
velkoniet	melkoniet
melandourn	melldorn
humvellein	mellamelli
melhec	mellek
melodiuz	melodius
melodiussa	melodius
memored	memoret
mn	men
menezidymenezis	meneziadmenezad
meneziad	meneziadmenezad
menezis	meneziadmenezad
menirein	menieri
Menk	menk
vennedigueah	mennedigezh
merag	merak
'metrak	merak
merag	merak
merc'hejoufall	merc'hfall
merherhelluru	Merc'her
meritein	meritoutmeritameriti
miritussoc'h	meritus
merchadeu	merkad
merchad	merkad
Verleac	Merleag
verzerinti	merzherinti
merzerentiou	merzherinti
Merzerentiou	merzherinti
verzerenti	merzherinti
herveskaden	meskadenn
mestrarmo	mestrarmo
mestrboutailher	mestrboutailh
mestrboutailler	mestrboutailher
mestrdanz	mestrdas
mistrilabour	mestrlabour
mstrpost	mestrpost
mestrezker	mestrezkr
arvestrezkear	mestrezkr
arvestrezplac'h	mestrezplac'h
mestrezplac'h	mestrezplac'h
meitour	metaer
meudet	meudameudi
aveudataz	meudata
mentuka	meudika
meudikaz	meudika
vudukis	meudika
meuleudiuz	meuleudius
meramant	meramant
meri	merameri
meri	merameri
eurveurdez	meurdez
meret	meret
meuriadou	meuriad
veuriad	meuriad
vorlarjeza	meurlarjezameurlarjezi
meuta	meuta
mevelbian	mevelbihan
Arveveliengobr	mevelgopr
vevellabour	mevellabour
mevin	mevi
mezepet	mezepet
mezepet	mezepet
mezidigez	mezhidigezh
mevezein	mezvezi
mzvyeresed	mezvierez
meahus	mezvus
mecherourpleg	micherourpleg
mignaoual	mignaoual
avignaoue	mignaoual
Mignouneta	mignoneta
Mikeal	Mikael
Mikeal	Mikael
Mikael	Mikael
guimikeal	Mikael
c'hoelMikeal	Mikael
visgouilMikl	Mikael
houilmikl	Mikael
Hevelmil	mil
mild	mildie
eurvilinesken	milinheskenn
milinwenteres	milinwenterez
Ervelinguenters	milinwenterez
miller	miller
melzin	milzin
vindrail	mindrailh
mindrail	mindrailh
minor	minor
minor	minor
minorik	minor
minoret	minoret
minoten	minotenn
urvinotten	minotenn
minoueret	minoueret
mison	mison
misonajo	misonajo
misonet	misonet
mintinvezou	mintinvezh
mintinves	mintinvezh
vintinvez	mintinvezh
mintinvez	mintinvezh
mintous	mintous
Minvroud	minvroud
frouezmir	mir
Mirra	mira
miraculus	mirakulus
miraculus	mirakulus
miraculuz	mirakulus
mirakuluz	mirakulus
visioni	misionimisionat
mitieret	mitieret
mitik	mitig
Miz	miz
mizerdedistac'h	mizerdedistac'h
visericord	mizerikord
misericord	mizerikord
misericordius	mizerikordius
moalet	moala
morfad	moarvat
Moc'haer	moc'haer
moc'herez	moc'herezh
arvoderasion	moderasion
modestiss	modestiz
vodignsou	modigaso
modigansou	modigaso
moded	modi
voerebkoz	moerebkozh
mogedadenn	mogedadenn
Moelanis	Molaniz
Monica	Monika
Monika	Monika
monstrus	mostruus
monstrussan	mostruus
mor	mor
o	morad
mourailleu	morailh
moraillou	morailh
mouralio	morailh
arvoralen	moralenn
morbigued	morbig
morbigmarellet	morbigmarellet
mordien	mordien
moret	moret
morgizhier	morgazh
morgenn	morgenn
morgenn	morgenn
morgevnid	morgevnidenn
morian	morian
morillon	morilhon
morillon	morilhon
moritelhat	moritellat
morlein	morlei
morliqin	morlikin
Morlivid	morlivid
morvleizy	morvleiz
morvraguez	morwreg
morsyouprenn	morzprenn
motennet	motennet
mo	mou
voaren	mouarenn
Arvouarenvraz	mouarennvras
moucht	mouched
mouchette	mouched
mouchet	mouched
eurvouchenn	mouchenn
baramouchen	mouchenn
Mouchenn	mouchenn
mouchourjubile	mouchouerjubile
moudenned	moudenn
eurvoudenn	moudenn
moudedbrizy	moudennvrizi
mouistet	mouestet
urvouez	mouez
mougergoulou	mougergoulo
mouguereah	mougerezh
Moumou	moumoun
moumoun	moumoun
moumoun	moumoun
Moumoun	moumoun
Moumoun	moumoun
moumoun	moumoun
Moushwarzin	mousc'hoarzhin
vousc'hoarzin	mousc'hoarzhin
vousc'hoarzin	mousc'hoarzhin
mousqedryen	mouskeder
mouskin	mouskin
mousclennet	mousklennet
moust	moust
moust	moust
moust	moust
mouster	mouster
Moustrer	moustrer
mouamant	mouvamant
arvouamant	mouvamant
mouzik	mouzhig
mudet	mudet
muds	mudez
mudez	mudez
muduren	mudurun
arvudurenn	mudurun
muiarmui	muirmui
muihamui	muihamui
muiouzvui	muiouzhmui
muiochvui	muiouzhmui
muiouzvui	muiouzhmui
muiedigeah	muiedigezh
vunsat	musat
vunzunou	munsun
multrer	muntrer
multrr	muntrer
muntrereset	muntrerez
eurvuntrerez	muntrerez
muntriach	muntriaj
munud	munut
munusya	munuzatmunuziamunuzi
Munuzein	munuzatmunuziamunuzi
murmulou	murmur
murmuration	murmurasion
murmurerez	murmurerezh
B	mut
mut	mut
II	mut
diaulmud	mut
muselleguesed	muzellegez
mezul	muzul
muzul	muzul
drevuzur	muzul
avusulma	muzul
nadozet	nadozi
nadozet	nadozi
aeredmor	naervor
nandecvd	naontekvet
Naontekved	naontekvet
naoteget	naontekvet
nar	nar
nard	nard
Nasket	nasket
humnaturrat	naturaat
naturel	naturel
ne	ne
neanded	neanded
neantet	neantet
nebon	nebaon
nebaoun	nebaon
nebaoun	nebaon
Nebonn	nebaon
Nebonn	nebaon
nec'heta	nec'het
nec'het	nec'het
anec'he	nec'hi
enemnec'hi	nec'hi
neiziaoui	neizhiaoua
neket	neket
neket	neket
neket	neket
neket	neket
ne'kuir	nekwir
nekuir	nekwir
Nekuir	nekwir
nervennet	nervennet
nerzet	nerzhet
enerhussa	nerzhusaat
Neuliegiz	Neuliegiz
neuennat	neuvennat
neuennat	neuvennat
neuzvad	neuzvat
neusdet	neuzded
neuen	neuzenn
neuet	neuziet
SantNeven	Neven
nevez	nevez
nevez	nevez
nevez	nevez
nevezflamm	nevezflamm
nevezflamm	nevezflamm
nehuhan	nevezhav
nehuhan	nevezhav
nevezet	nevezet
nevezet	nevezet
Nevnty	nevezinti
newentis	nevezinti
nevesenti	nevezinti
nevezenti	nevezinti
newentiz	nevezinti
nevezenti	nevezinti
nezadegou	nezadeg
niel	niell
nenn	nienn
niezen	niezen
nigoudouill	nigoudouilh
Nil	Nil
Nil	Nil
nisbihan	nizbihan
nizez	nizeznieznizh
nizez	nizeznieznizh
NoalPondi	NoalPondivi
Noal	NoalPondivi
noazpidiboulc'h	noazhpidiboulc'h
noazpik	noazhpik
ennnoazpillen	noazhpilhenn
noazoutdehoc'h	noazoutnoazinoaz
noazoutd'	noazoutnoazinoaz
noazoutouzomp	noazoutnoazinoaz
noazoutoute	noazoutnoazinoaz
noble	noble
noblechin	noblechin
nombrus	nombrus
nombrus	nombrus
Nonnik	Nonnig
normand	Normand
Ormandie	Normandi
Normandi	Normandi
Normandi	Normandi
yonyan	noter
nolen	nouelenn
n'ousketpegeit	nousketpegeit
nousketpet	nousketpet
n'ousketpet	nousketpet
n'ouspegeit	nouspegeit
nouzpegeit	nouspegeit
nshadeiz	nozhadeiz
nozpad	nozpad
nosveziennou	nozvezhienno
nouabren	oabrenn
oberiou	ober
ober	ober
oberiou	ober
ober	ober
ober	ober
obrus	oberiusoberus
gobrus	oberiusoberus
oberius	oberiusoberus
oblijet	oblijet
oblijet	oblijet
bezaffeoobliget	oblijet
odeougarr	odegarr
odivi	odivi
eu	oes
offerenneured	oferenneured
varblean	oferennwarblaen
offertour	ofertouer
aoglenn	oglenn
Oglenn	oglenn
ograouet	ograoui
oliou	oliou
honestadur	onestadur
onganti	onganti
onganti	onganti
onix	oniks
leson	onn
opium	opiom
opium	opiom
opiusa	opiusa
oracl	orakl
oredas	oredi
orglzeu	orglez
orglseu	orglez
orijinel	orijinel
ornia	ornaorniornia
horrerus	orrolus
horrerus	orrolus
horrerus	orrolus
horerus	orrolus
horrerus	orrolus
anHospitalCamfrout	OspitalKammfroud
Hospitallerien	ospitaler
Ostand	ostant
ostant	ostant
ostenminiq	ostant
autegraf	otegraf
autramant	otramant
autramanteguet	otramant
ouari	ouari
oc'h	ouc'h
oulch	ouelch
oulm	oulm
aiawarheourzik	ourzig
Pa	pa
paboni	paboni
baboni	paboni
padable	padapl
padereah	paderezh
padereah	paderezh
Padurez	padurezh
paan	paian
baillardd	pailhard
irbaillardigueah	pailhardigezh
baillardigueah	pailhardigezh
erbaillardigeh	pailhardigezh
pacqou	pak
palyourod	palrod
Palattadeu	palad
abaladeu	palad
erbaladeg	paladeg
parlako	palank
palarennou	palarenn
palefarzet	palefarzhet
balforcemant	palforsamant
pallennouqesecq	pallennmarc'h
palourad	palouerapalouerat
paloueret	palouerapalouerat
palouera	palouerapalouerat
Paltokennad	paltokennad
Paludenn	paludenn
eurbaludenn	paludenn
Baluden	paludenn
pn	pan
panerhada	panerhada
pansit	pasi
Pantei	pantei
PaonPaon	pao
baotdistro	paotrdistro
potrkeguiner	paotrkeginer
baotrezsaout	paotrezsaout
paotredigo	paotrig
paourdu	paourdu
paournoas	paournoazh
paourateach	paourentezaj
parahaul	paraheol
paramailho	paramailh
para	para
para	para
para	para
baraouz	para
parbleur	parbleur
Parbleur	parbleur
Parbleur	parbleur
pardaezvez	pardaevezh
pardaesvez	pardaevezh
bardavez	pardaevezh
pardaeznoz	pardaeznoz
pardaeznoz	pardaeznoz
pardaeznoz	pardaeznoz
pardaenoz	pardaeznoz
pardaeznoz	pardaeznoz
pardien	pardien
epareas	parea
Parea	parea
parea	parea
enembareas	parea
pareed	pareet
erBarrss	pares
pars	pares
pargurun	pargurun
paridiguez	paridigezh
parissein	parisi
parjur	parjur
parkarsiliou	parkarsilio
parkeerleton	parkleton
farca	parka
parresioukanton	parrezkanton
eurbarressiad	parreziad
enebart	part
enhebard	part
enhefart	part
ennhefart	part
Enhofard	part
eurbarti	parti
dioubarty	parti
urbarti	parti
ur	parti
Eurbarti	parti
parveni	parveni
passabl	pasabl
passabl	pasabl
passant	pasant
bascal	paskal
pasket	paska
Pasteei	pasteza
patato	patato
patao	patav
pataoec	pataveg
arBater	pater
arBater	pater
Pater	pater
Urbater	pater
Bater	pater
Bater	pater
Fater	pater
Paterou	pater
paterdom	pater
paterennet	paterennet
pat	pato
batoni	patoni
ArBatriarched	patriarch
patromage	patromaj
pave	pavez
pave	pavez
paveou	pavez
bave	pavez
bave	pavez
pogammed	pavgamm
p	pe
p	pe
II	pe
pe	pe
pe	pe
taulchanche	petaolchas
peblma	pebel
pebrourou	pebrouer
nebhedetquet	pec'hedi
Urbec'heurez	pec'herez
pedu	pedu
napegeit	pegeit
abegeit	pegeit
pegueid	pegeit
pgource	pegoulz
pegours	pegoulz
Aoudpegource	pegoulz
paissellieu	peisell
pellen	pellenn
pempennenn	pempenenn
pempenni	pempenni
pempiao	pempiga
benefi	penefi
pengeneign	pengenni
penitand	penitant
penjdeneign	penjodenni
pennaraog	pennaraog
pennaraog	pennaraog
pennaraoc	pennaraog
pnnousqull	pennaskell
pennbizyer	pennbazh
pennbah	pennbazh
phenbaz	pennbazh
pennbaz	pennbazh
pennchatal	pennchatal
penndibenn	penndibenn
penngoulou	penngoulo
pennkenta	pennkenta
pennkenta	pennkenta
pennkenta	pennkenta
pennkenta	pennkenta
pennoukenta	pennkenta
penneuquetan	pennkenta
pennoukenta	pennkenta
pennoukenta	pennkenta
pennochas	pennki
penpill	pennpilh
taolpennskoaz	pennskoaz
pentiec	penntieg
pennask	pennask
penaska	pennaska
pennbonnet	pennbouzellet
pendrabet	penndrabi
Penduik	pennduig
Penduik	pennduig
Arbennegez	pennegez
Penngez	pennegez
penuvr	penneuvr
pennfoll	pennfoll
penfolet	pennfollet
penfollet	pennfollet
pennfollet	pennfollet
pnfond	pennfont
penfond	pennfont
penglina	pennglina
pennivinet	pennivinet
penivinet	pennivinet
penkonz	pennkomz
bnlzenneu	pennlezenn
pennlzen	pennlezenn
penseet	peseet
penseet	peseet
pentonkoue	pentonkouez
penturi	penturi
penveuzet	penveuzet
p'eguir	peogwir
pegwir	peogwir
p'eguir	peogwir
berc'henna	perc'hennaperc'henni
Perc'henna	perc'hennaperc'henni
perier	perier
perier	perier
perlesegued	perlezeg
arbermission	permision
Perrot	perod
perpetuel	perpetuel
perpetuel	perpetuel
PerrozHamon	PerrozHamon
motd'arpers	pers
erberseverance	perseveras
persvrance	perseveras
personetcanton	personkanton
perterissein	perterisi
perhuhussoh	pervezhus
besque	pesk
pesked	pesk
pesked	pesk
pesket	pesk
taulpesked	pesk
peskedkrogennek	peskkrogennek
peskedcrogennog	peskkrogennek
Peskkrogennek	peskkrogennek
pesqetaryen	pesketaer
pesquetarion	pesketaer
Abet	pet
Abet	pet
Abet	pet
D'arpet	pet
petore	petare
petare	petare
pedare	petare
pedare	petare
ptelek	peteleg
betesa	petesa
petezenn	petezenn
Petoare	petore
ptreure	petore
petreure	petore
Petore	petore
Petore	petore
Petore	petore
Peuk	peuk
taulpeucq	peuk
peuk	peuk
Peulgwini	peulgwini
peulpost	peulpost
peullioutavarn	peultavarn
peulvanou	peulvan
Peur	peur
peurach	peuraj
peuraliesoc'h	peuraliesoc'h
peurbare	peurbare
peurbrenan	peurbrena
peurc'hreat	peurc'hraet
beurderri	peurderri
nabeurdorroket	peurderri
berdler	peurdeurel
perdrachat	peurdrachat
peurdrec'het	peurdrec'hi
perdroed	peurdrei
peuraichu	peurechu
peurachu	peurechu
bereffassi	peurefasi
peurfin	peurfin
abeurfollaz	peurfolli
abergaledas	peurgaledi
beurgarga	peurgarga
beurgarga	peurgarga
peurgarguet	peurgarga
feurgarga	peurgarga
abeurglask	peurglask
peurglasq	peurglask
Peurglozet	peurglozet
peurgreaat	peurgrevaat
abeurgresq	peurgreski
aberjoausaaz	peurjoaiusaat
perjouissa	peurjouisa
peurlaza	peurlazha
peurlazet	peurlazha
abeurlaz	peurlazha
peurlaza	peurlazha
peurlaza	peurlazha
peurlazaz	peurlazha
peurliesa	peurliesa
Peurliesa	peurliesa
arpeurliesa	peurliesa
pernetaat	peurnaetaat
peurnetaat	peurnaetaat
peurnetaat	peurnaetaat
beurnetaat	peurnaetaat
peurnettt	peurnaetaet
Peurranna	peurranna
peurrest	peurrest
peurest	peurrest
perrest	peurrest
peurest	peurrest
beursavetei	peursavetei
peurzilet	peursila
peurzila	peursila
aberscleraio	peursklaeraat
abersonjas	peursojal
peurvaro	peurvarv
peurvaro	peurvarv
peurvaro	peurvarv
beurvoulla	peurvoulla
pervua	peurvuia
drebeurvuia	peurvuia
drebervuia	peurvuia
pervisca	peurwiska
peurwriet	peurwriat
berdallan	peurzalla
Perdebrei	peurzebri
peurzeski	peurzeski
perdeski	peurzeski
beurzibenna	peurzibenna
beurdimezi	peurzimezi
peurdispin	peurzispign
abeurzistag	peurzistaga
beurzistruja	peurzistruja
peurdistruja	peurzistruja
Maperdeuio	peurzont
feuse	peuse
zularPusdibus	peuzdibeuz
Peuzdibeuz	peuzdibeuz
peushenvel	peuzhevel
peushir	peuzhir
zularPuslard	peuzlard
peushul	peuzuhel
Puarhant	pevarc'hant
pevarc'hant	pevarc'hant
pvarennou	pevarenn
urbvarenn	pevarenn
pevarenn	pevarenn
arbevaret	pevaret
Pesavad	pezhavat
pezhiokoad	pezhkoad
pezlabour	pezhlabour
ennhebezpikol	pezhpikol
pezad	pezhiadpezhad
pechad	pezhiadpezhad
pezic	pezhig
pi	pi
piastr	piastr
Pibit	pibid
pifidet	pibida
bifiga	pibida
bichonclom	pichonkoulm
o	pif
bifo	pif
piketgrisias	piggrizias
pignoun	pignon
bikiliat	pikailhat
Pikerigarguez	pikerigargwez
peklienn	pikolenn
Pikolenneu	pikolenn
bicota	pikotapikotat
pildour	pildour
pilglao	pilglav
pilcojou	pilkaozio
piladdour	piladdour
pilet	piled
pilletteu	piled
piled	piled
pilejou	piled
piletanangoni	piled
pillerad	pilerad
Pillerezheguenou	pilerezhegeno
pillennek	pilhenneg
pilprennat	pilprennat
pilgos	piltos
piltosek	piltosek
pimant	pimant
pin	pin
pin	pin
pingoues	pingouez
Pingwz	pingouez
peniguen	pinijenn
oberpenigen	pinijenn
pinijen	pinijenn
Kadorarbinijen	pinijenn
binijenn	pinijenn
Pinnijenner	pinijenner
pinijennuz	pinijennus
Pintekhpintekh	pintik
Piou	piou
Pipia	pipial
pipon	pipon
pipon	pipon
berhindettat	pirc'hindetat
Perhenderez	pirc'hirindourez
Pismigal	pismigapismigat
bistach	pistach
Pistaon	pistaon
bistiga	pistiga
pistiget	pistiga
abistigas	pistiga
Pistiguet	pistiga
pistiga	pistiga
bistiga	pistiga
enembistiga	pistiga
pistokat	pistokat
pitach	pitach
pitekhiar	piteker
pitik	pitik
pitouch	pitouch
Pitouch	pitouch
pizhapiz	pizhhapizh
plac'hcavel	plac'hkavell
plac'hkavell	plac'hkavell
plac'hedkrot	plac'hkrot
blac'hkrot	plac'hkrot
plac'hedbihan	plac'hvihan
arbladenvene	pladennvenez
pladennec	pladennek
pladoucennet	pladousennet
plean	plaen
plein	plaen
blean	plaen
blean	plaen
plean	plaen
plen	plaen
warbln	plaen
abln	plaen
ablean	plaen
Ablen	plaen
blanchein	plachi
planonneu	plason
blanson	plason
urblanonen	plasonenn
urblanonnen	plasonenn
blansounet	plasonet
blansonet	plasonet
plantedigez	plantedigezh
plantenne	plantenni
eblanten	plantenni
neblantennou	plantenni
plantet	plantet
placet	plaset
placet	plaset
placet	plaset
plat	plat
platenneneu	platinenn
plafet	plavet
Plianiz	Plianiz
ploboro	ploboro
blocuri	plokuriplokuli
plomaplom	plomhaplom
blou	plou
Plouaridiz	Plouarediz
Plouganaouis	Plouganaouiz
Plouganaouiz	Plouganaouiz
Plougoulm	Plougouloum
Plougouloum	Plougouloum
Blouvornis	Plouvorniz
plousegou	plouzeg
vlouzenna	plouzenna
Plren	Ploveren
plunnouearc'h	pluerc'h
eurbluenerc'h	pluerc'h
pluet	pluvet
plusk	plusk
poah	poah
ponyu	poan
poanio	poan
poanio	poan
andudaboan	poan
andudaboan	poan
poan	poan
drboen	poan
arboanc'houzoug	poanc'houzoug
poangaloun	poangalon
arboangostez	poangostez
poanSantCadou	poansantKadou
boanspered	poanspered
arboac'haden	poazhadenn
poahant	poazhant
erboahson	poazhezon
poazidic	poazhidik
urboblad	poblad
arboblad	poblad
Dallpoch	poch
henvelpoch	poch
henvelpoch	poch
henvelpoch	poch
fohonage	poc'honaj
potbassin	podbasin
potcambr	podkambr
hefodtrutell	podtrutell
poellus	poellus
foenchen	poechenn
spoes	poes
poins	poes
pokholpoyol	pokiol
pokholpoyol	pokiol
folezi	polez
pouliz	polis
poliz	polis
polisenni	polisenni
politik	politik
Polozen	polosenn
Pomperien	pomper
pompinello	pompinell
pounsoun	poson
pontlosket	PontLosket
pontmenou	PontMenou
porc'helgouez	porc'hellgouez
porc'helgouez	porc'hellgouez
pourceln	porselen
porteraid	porteled
bortezat	portezaportezalportezat
portezat	portezaportezalportezat
porteal	portezaportezalportezat
portughs	portugez
porsguint	porzhgwint
Borzcaer	PorzhKaer
porscloz	porzhkloz
porskloz	porzhkloz
porzmeur	porzhmeur
porzmeur	porzhmeur
PorzOliod	PorzhOlued
porsrastel	porzhrastell
bos	pos
postel	postel
eurbostel	postel
postel	postel
posterite	posterite
postillon	postilhon
beudr	poudr
Poulldoura	poulldoura
poullaounez	poullhavouez
poullcanna	poullkanna
poullomor	poullmor
poullouscorf	poullskorf
pouldroennou	poulldroenn
Poullet	poullet
c'hoaritoulpouliq	poullig
poupicargalon	poupig
pourchaset	pourchaset
bourmeni	pourmenpourmeni
pourceln	pourselen
pourvuet	pourvui
enembourvuet	pourvui
poud	pout
poud	pout
erbouvor	pouvoer
poz	poz
post	poz
pozn	pozenn
posset	pozet
pozett	pozetaat
prajeyer	pradtirien
pradet	pradet
pred	pred
pred	pred
pridiriguez	prederigezh
prehesion	predesionprehesion
arbreferans	preferas
prezeg	preg
breg	preg
preghet	preg
ed	prei
prenvetguen	prevgwenn
prevedlugern	prevlugern
ion	preponier
arbres	pres
precho	pres
pres	pres
presuer	presouer
pressouer	presouer
pressor	presouer
prestou	prest
prst	prest
prestou	prest
presteu	prest
presteu	prest
prst	prest
preuveno	preuvenn
pridouar	pridouar
bridouar	pridouar
priet	priet
primhaprim	primhaprim
primhaprim	primhaprim
Prinsez	prisez
Priol	priol
Priol	priol
briolage	priolaj
prizachet	prizajet
provei	profaprofiprof
profanein	profani
broffani	profani
arbrophesi	profesi
Profesia	profesiaprofesii
ebrofsias	profesiaprofesii
arbrofessiez	profesiezh
feurlok	prolog
erbromesse	promes
promesaou	promesa
promessa	promesa
bromessaou	promesa
bromission	promision
bromission	promision
urbrontit	prontite
propic	propik
Propig	propik
arbrocession	prosesion
arbrosesion	prosesion
arbrosesion	prosesion
procesi	proseziprosezal
brosezi	proseziprosezal
humbrosternein	prosterni
frotegi	proteji
protestant	protestant
protestant	protestant
prouf	prou
arbrovidans	providas
providans	providas
provins	provis
Prozen	prozenn
urbrosen	prozenn
psalmeri	psalmeri
psalterion	psalterion
puchet	puchet
Puilla	puilha
punet	punet
peunet	punet
bura	pura
pura	pura
purnez	purnezh
pussuniet	pusuniet
pusuniet	pusuniet
rabin	rabin
rabotet	rabotet
racanellat	raganella
raouennatabro	rahouennata
rakrak	rak
raquit	rakuit
rampla	rampla
ramplus	ramplus
ramplus	ramplus
ran	ran
ran	ran
randounen	randonenn
randonen	randonenn
Randonenn	randonenn
randounen	randonenn
randoni	randoni
arandone	randoni
ranez	ranez
ramezeneignramzeneign	ranezenni
ranjemant	rajamant
rangennet	rajennet
Rangennet	rajennet
darancontr	rankontr
dreeurrankontr	rankontr
rannour	ranner
rannerien	ranner
rannet	rannet
rangalon	ranngalon
rangalon	ranngalon
ranngaloun	ranngalon
ranngaloun	ranngalon
rangaloun	ranngalon
ranngaloun	ranngalon
ranngalon	ranngalon
rangalon	ranngalon
rannvroat	rannvroat
ransen	rasenn
ranoni	rasonarasoni
Rao	rao
rapine	rapin
rapint	rapinarapini
erapin	rapinarapini
marapin	rapinarapini
rapinerion	rapiner
hrassamble	rasambli
ratik	ratik
raou	rav
ravach	ravaj
ravaich	ravaj
ravanellou	ravanell
ravnd	ravent
ravechou	ravent
raviss	ravis
ravoderez	ravoderezh
ravodereziou	ravoderezh
revolt	ravolt
ravolt	ravolt
ravolt	ravolt
ravolt	ravolt
revoltet	ravoltet
ravoltet	ravoltet
revoltet	ravoltet
razok	razek
razhediliz	razhiliz
raeden	razhedenn
Eraz	razi
reoll	reholl
reoll	reholl
realamant	realamant
rebech	rebech
rebreicheu	rebech
rebechou	rebech
rebechou	rebech
rebech	rebech
zevelrebechennhoc'h	rebech
rebech	rebech
rebechou	rebech
rebechet	rebechrebechirebechat
arebele	rebellarebelli
arebeleoud	rebellarebelli
rebellus	rebellus
rebiz	rebiz
rec'ha	rec'hi
rec'hi	rec'hi
red	red
dohurret	red
dreeurred	red
riddeur	reddour
ridgoaid	redgwad
redcorf	redkorf
redadek	redadeg
redadec	redadeg
redadeg	redadeg
Redemsion	redempsion
rederienvor	redermor
rederpri	rederpri
rederez	rederez
redia	redia
redouten	redoutenn
redouti	redouti
Reed	reed
refiziout	refiziout
refurmein	refurmi
areguemras	regemer
ereguemr	regemer
rgl	regl
reglet	reglet
regnet	regnet
rei	rei
reigolo	rei
reigolo	rei
rein	rei
voar	rei
enemro	rei
enemrei	rei
enemrei	rei
Enemrei	rei
enemrei	rei
da	rei
enemrei	rei
enemrei	rei
reh	reizh
rezmad	reizh
reihhasplann	reizh
reihhasplann	reizh
reihhasplan	reizh
reihhasplann	reizh
spis	reizh
reihhanet	reizh
reizvuele	reizhwele
reizvuele	reizhwele
reizamant	reizhamant
reizet	reizhet
rejanti	rejanti
Kozrejis	rejis
requinage	rekinaj
requintus	rekintus
Reclommeu	reklom
reclom	reklom
reclom	reklom
arecommandas	rekomandi
reconciliation	rekosiliasion
Recordet	rekord
recorded	rekord
relation	relasion
relia	relia
remarquable	remarkapl
remi	remii
II	ren
arendaren	ren
reniour	reneer
avalourenettn	renetan
Reneumant	renevezamant
reneuamant	renevezamant
renevezi	renevezi
renevezi	renevezi
reneein	renevezi
renevezi	renevezi
reni	reni
renji	reji
rencharenc	renkharenk
renkennet	renkennet
renket	renket
renket	renket
reklen	renklenn
renoncereah	renoserezh
renonci	renosi
groeitrenonci	renosi
renoumad	renou
renoumad	renou
renoumad	renou
reveres	reverezh
reverez	reverezh
reoliet	reoliet
reparours	reparourez
reposuan	repozvan
reposvan	repozvan
reposvan	repozvan
republikan	republikan
republikan	republikan
republikan	republikan
rebutein	reputareputi
rebutet	reputareputi
rebutet	reputareputi
humrebutein	reputareputi
reputation	reputasion
rzamma	resamma
recevour	resever
resever	resever
recevour	resever
receuerion	resever
reseourien	resever
rescondable	respontapl
resteu	rest
restamzer	restamzer
aretourn	retorn
aretorn	retorn
aretorn	retorn
aretorn	retorn
aretorn	retorn
reusklen	reusklenn
reusklen	reusklenn
reutaat	reutaat
Reogwenn	revgwenn
Reogwenn	revgwenn
Reogwenn	revgwenn
marevager	revaga
reage	revaj
reveursi	reveulzi
revwet	revevet
rewi	revi
rezdarez	rezdarez
rezinen	rezinenn
rezinenn	rezinenn
rian	rian
ribincq	ribin
ribincqou	ribin
ribinou	ribin
ribin	ribin
ribin	ribin
ribin	ribin
eclasceribinou	ribin
riblad	riblad
riblein	riblaribli
riblennou	riblenn
ribotaden	ribotadennribodadenn
Ribouldiriboul	ribouldiriboul
riboul	ribouldiriboul
richen	richen
ridicul	ridikul
ridicul	ridikul
rifortirvin	rifordirvin
rikamana	rikamana
rimadella	rimadella
rimadelled	rimadellet
rimaderez	rimaderezh
rimet	rimet
rioln	riolenn
rioleneu	riolenn
riolen	riolenn
riolen	riolenn
ariolen	riolenn
ariolen	riolenn
rip	rip
ricin	risin
risk	risk
risk	risk
eriscda	risk
eriscda	risk
eriscda	risk
riskuz	riskus
riscuz	riskus
riscusbras	riskus
riou	riv
riou	riv
riou	riv
sklasi	riv
ridet	riv
rivinet	rivinet
rijennou	rizenn
rizennou	rizenn
rizennou	rizenn
rizeennomae	rizennvaen
rizennouvoguer	rizennvoger
roc'helleg	roc'hellek
Rodell	rodell
arodel	rodell
n'emrodelenni	rodellenni
Rogasionou	rogasion
rognat	rognat
rouignek	rognek
roqueden	rokedenn
rokeden	rokedenn
rokeden	rokedenn
rokedenn	rokedenn
rollad	rollad
rolec'hus	rollec'hus
roltet	roltet
roumen	roman
romen	romen
rounkounenna	ronkonenna
Roskoaden	Roskoadenn
rost	rost
rotin	rotin
rotin	rotin
Rouanez	rouanez
ruanies	rouanez
Roans	rouanez
Rouanez	rouanez
Rouanezarfoennek	rouanez
rouch	rouch
roud	roud
enheroud	roud
rontt	roud
rontt	roud
ronte	roud
Roud	roud
roudou	roud
gantroudou	roud
drevaroudou	roud
dreroudou	roud
roudienet	roudennet
roudennet	roudennet
rouoni	roueoni
rouonni	roueoni
rouoni	roueoni
rouoni	roueoni
roufennet	roufennet
roufennet	roufennet
rousset	rouset
roustadou	roustad
roustadbac'hadou	roustad
rousvenn	rouswenn
rouzannoz	rouzannoz
rouzet	rouzet
rozellopillig	rozellbillig
rozelloforn	rozellforn
rozel	rozellforn
taolru	ru
taolru	ru
taolru	ru
taolru	ru
ruad	ruad
rudizec	rudizeg
ruellat	ruellat
ruilhadennou	ruilhadenn
rillennouscouarn	ruilhennskouarn
rucunus	rukunus
rukunuz	rukunus
rukunuz	rukunus
rumadigueah	rummadigezh
rustage	rustaj
ruroz	ruzroz
ruzven	ruzwenn
ruzven	ruzwenn
sa	sa
sa	sa
sablen	sablenn
sabrenn	sablenn
sabrenet	sabrennet
zac'ha	sac'ha
Sac'het	sac'het
zac'hleue	sac'hleue
sac'hellok	sac'hellek
zac'helek	sac'hellek
sadornevasque	SadornFask
zahouarn	saehouarn
zaezu	saezu
Bvinsazon	saesonsaezon
saezonet	saesonetsaezonet
ssonnet	saesonetsaezonet
sacr	sakr
zalmatenein	salamantenni
saladeu	salead
salad	salead
salissa	salisa
zalmatenein	salmantenni
zaltin	saltin
zaltin	saltin
saluder	saluder
zam	samm
samet	sammet
sammuz	sammus
sammuz	sammus
sammusoc'h	sammus
zamsonzamsonecq	samson
sanedrin	sanedrin
sanklet	sanket
Sans	sas
sansipl	sasipl
sansipla	sasipl
sansibl	sasipl
SantGoustan	SantGoustan
SantGultasaRheuys	SantGweltazaRewis
SantKePorstreo	SantKePorzhTrev
SandMartinis	SantMartiniz
zantparon	santpaeron
ZantPaeron	santpaeron
SantVazePennarbed	SantVazhePennarBed
SantVazePennarBed	SantVazhePennarBed
SantVaze	SantVazhePennarBed
SantIanniz	SantYanniz
santabl	santapl
santleit	santelaat
santelaat	santelaat
enemsantelaat	santelaat
enemzantelaat	santelaat
santeledigez	santeledigezh
zantelezi	santelezhasantelezhi
santefiadur	santifiadur
zantimitouch	santimitouch
zantuar	santual
o	saotr
saotr	saotr
saotr	saotr
saour	saour
seudanec	saouzanek
sauvet	saovi
Saosizien	Saoz
JanSos	Saoz
saoz	saoz
zauza	saoza
zauzein	saoza
zauzer	saozer
zznach	saoznaj
sauzon	saozon
sargalon	sargalon
zermounerrien	sarmoner
satindor	satindor
zaoreleg	savreleg
saotoll	savtaol
saotol	savtaol
saotaol	savtaol
saotol	savtaol
savajiri	savajiri
savajiri	savajiri
ch	se
Ch	se
chei	se
ch	se
ch	se
seblant	seblant
seblandiq	seblant
groeitseblantmaterbet	seblant
seblantuz	seblantus
seblantus	seblantus
sec'hor	sec'hor
sec'hor	sec'hor
zec'hor	sec'hor
zec'hor	sec'hor
sec'horiou	sec'hor
sec'horiou	sec'hor
sc'horiou	sec'hor
sec'hedet	sec'hedet
shedigueah	sec'hedigezh
schenned	sec'henn
sec'het	sec'het
shet	sec'het
Sed	sed
sadama	sed
asederaas	sederaat
sdraad	sederaat
Asederre	sederaat
sederd	sederaat
zedra	sedra
cedren	sedrenn
segallmarr	segalmarr
seguestn	segesten
Seit	seit
st	seit
seitcvd	seitekvet
Seitekved	seitekvet
zeiteget	seitekvet
sex	seks
sex	seks
sex	seks
cheleuettan	selaouet
cheleuettoh	selaouet
eselidas	selid
selletar	sellataer
selleryon	seller
Semeill	semeilh
Semennou	semenn
Seminer	seminer
simplamant	semplamant
simplamant	semplamant
semplet	semplet
semplet	semplet
sentabl	sentapl
sentuz	sentus
Sentus	sentus
sentuz	sentus
senthus	sentus
sentusous	sentus
cerat	serad
sermant	sermant
sermoulet	sermoulet
serruz	serrus
setm	setim
setim	setim
setim	setim
cetu	setu
chetui	setu
necetuqet	setu
Chetuperac	setu
Setuperag	setu
Setuperak	setu
Setuaman	setu
setuaman	setu
Setuama	setu
Setuaze	setu
setuaze	setu
Setuaze	setu
setuaze	setu
Setuarpeza	setu
Setuarpeza	setu
setuarpeza	setu
seuit	seuit
Sul	seul
sul	seul
seulave	seul
sevennetmad	sevenet
nesiket	sia
nsiket	sia
sich	sich
Siek	Sieg
syell	siell
sciel	siell
lizerousyell	siell
syellet	siellasielli
siella	siellasielli
aziellaz	siellasielli
ziella	siellasielli
siellet	siellasielli
siellet	siellet
sciet	siet
Siet	siet
siet	siet
Sigougn	sigognsigon
sigonnd	sigognsigon
Sik	sik
zoken	siken
ciquet	siket
asecouro	sikoursikouri
sikour	sikoursikouri
zikourouz	sikoursikouri
daemsycour	sikoursikouri
aenemsikouras	sikoursikouri
scil	sil
zil	sil
II	sil
azil	sil
B	sil
silanour	silasour
sizldoeresou	sildrouerez
silet	silet
selvidigez	silvidigezh
obervazilvidiguez	silvidigezh
porzarzilvidigez	silvidigezh
Sembolen	simbolenn
symbolen	simbolenn
Symbolen	simbolenn
Symbolen	simbolenn
simoniach	simoniezh
simpad	simpat
Sina	Sina
chinad	sinaat
chinad	sinaat
sinvez	sinvezh
sioulamant	sioulamant
zioula	sioula
sioulec	sioulek
Sipozomp	sipozi
Sisakre	sisakre
citrouillezen	sitrouilhezenn
ciudis	siudis
sivellenna	sivellenna
Cibolesen	sivolezenn
Suhunourrnerion	sizhuner
sizunveziou	sizhunvezh
Eursizunvezioubennag	sizhunvezh
eursizunvezioubennag	sizhunvezh
sqebeltousseg	skabelltouseg
scabelloutoussegued	skabelltouseg
Skatek	skanteg
eskana	skavaat
Skavaat	skavaat
skanvaat	skavaat
scanvat	skavaat
scanvat	skavaat
skanvaad	skavaat
scanvaat	skavaat
skanvaat	skavaat
skanvadurez	skavadurezh
scnvadurez	skavadurezh
skanvadurezou	skavadurezh
skanbennet	skavbennet
scavelarded	skavelard
skanvente	skaventez
scanvigen	skavijenn
skarnila	skarnila
Askarnile	skarnila
scarh	skarzh
skarzeriengodellou	skarzhergodello
skas	skas
skas	skasi
Skagrac'hgwenn	skavgwrac'hgwenn
sked	sked
sked	sked
d'	sked
skeduzoc'h	skedus
skedus	skedus
skedus	skedus
skeduz	skedus
skeduz	skedus
skedus	skedus
skeduz	skedus
skeduz	skedus
skeduz	skedus
askedusse	skedusaat
skeltran	skeltra
skerbet	skerba
skeudennet	skeudennet
squdet	skeudi
skedet	skeudi
skeulc'houzoug	skeulc'houzoug
skeulc'houzoug	skeulc'houzoug
skeulc'houzouk	skeulc'houzoug
askiantvad	skiantvat
askiantvad	skiantvat
kolldaskiantvat	skiantvat
skiantvad	skiantvat
skiantamant	skiantamant
sqilfadou	skilfad
sqilfadennou	skilfadenn
skiltr	skiltr
skiltr	skiltr
askiltre	skiltra
skinsal	skisal
skipartein	skiparti
skismatik	skismatik
sklasan	sklasasklasi
sklasi	sklasasklasi
sklasi	sklasasklasi
sklent	sklent
sklent	sklent
Sklipad	sklipad
escypsas	sklipsi
esclins	sklipsi
esclipsas	sklipsi
scluye	skluia
Skoanenn	skoanennlaezh
skoagleu	skoazkleuz
scoazellouplec	skoazellbleg
Skoazella	skoazella
scep	skob
scod	skod
scodou	skod
skod	skod
scod	skod
scod	skod
Skod	skod
skodou	skod
scodaillet	skodailhet
scodaillet	skodailhet
aiaeskerj	skoelf
skoill	skoilh
sclat	skolaat
sclat	skolaat
scolage	skolaj
sclage	skolaj
Skolieta	skoliataskolata
skolieta	skoliataskolata
skora	skora
skora	skora
skoran	skora
skora	skora
Skorit	skora
skora	skora
Skoraskola	skora
enemscora	skora
scorfou	skorf
scorn	skorn
skorpul	skorpul
scrupulou	skorpul
skurpul	skorpul
Scosellec	skosellek
scocellus	skosellus
scosselus	skosellus
skouarned	skouarnet
skouerbak	skouerbank
skourjeta	skourjata
skraberienpaper	skraberpaper
scrabinein	skrabinaskrabini
scraberez	skraperezh
scrijou	skrid
scridou	skrid
skrijou	skrid
skridou	skrid
skridtamall	skridtamall
skrigndent	skrigndent
scrigndent	skrigndent
scrigndent	skrigndent
scrigndent	skrigndent
aroarscrigndent	skrigndent
scrignadll	skrignadell
scrij	skrij
Scrij	skrij
scrij	skrij
scrij	skrij
scrintellerez	skrintellerezh
chkrivanil	skrivagnol
scrihuet	skrivet
scubellryen	skubeller
skubunadou	skubennado
skudellotoaz	skudelldoaz
skouiz	skuizh
schuh	skuizh
skuiza	skuizha
askwizo	skuizha
skuiza	skuizha
eskuizganthi	skuizha
askuize	skuizha
skuizet	skuizha
skuizet	skuizha
skuiza	skuizha
enemskuizen	skuizha
enemskuiza	skuizha
schoni	skuizhoni
scuhonni	skuizhoni
skultret	skultet
scumennen	skumeennenn
souc'het	soc'het
ed	sodez
soignus	sognus
soignus	sognus
solen	solenn
solanelamant	solennelamant
zolierenn	solierenn
zonet	sonet
enemzonjal	sojalsoji
zonjal	sojalsoji
sontal	sonteal
sorbet	sorbet
sorc'heni	sorc'hennasorc'henni
jorda	sorda
Soroc'her	soroc'her
emogretmasorty	sorti
subeennei	soubenna
Soubeennourrnerion	soubenner
soubl	soubl
zoubl	soubl
zoubl	soubl
soup	soubl
soublien	soublien
soublien	soublien
soublien	soublien
soublic	soublik
soubouldou	soubould
chouchet	souchet
souchet	souchet
souc'het	souet
suhet	souezhet
zouhet	souezhet
Souezuz	souezhus
Choufretez	soufretez
souyned	souin
sulaourret	soulaouret
silaouret	soulaouret
chilaouret	soulaouret
silaouret	soulaouret
souldihoal	souldiwall
slen	soulenn
soumission	soumision
zourbilh	sourbilh
souret	souret
Sourina	sourina
souprenanta	sourprenant
zourrigal	sourrigal
soudanennet	soutanennet
souten	souten
soutenidigez	soutenidigezh
Spagnolt	spagnoled
Spagnolik	spagnolig
spalieren	spalierenn
Sparf	sparf
Spalourbras	sparfellvras
sparlouberr	sparlberr
speg	speg
Spek	speg
spek	speg
Spek	speg
speg	spega
Spgar	spegar
speguz	spegus
spell	spell
arSperedSantel	SperedSantel
sperejoDoue	speredoDoue
sperlezen	sperlezenn
sperlezen	sperlezenn
spernegou	sperneg
Spevia	spevia
spiour	spierspiour
Spinac'ha	spinac'haspinac'hi
spinac'het	spinac'haspinac'hi
spinac'het	spinac'het
spisonni	spisoni
splander	splannder
splannder	splannder
splanndr	splannder
splanzer	splannzer
Taolspl	sple
spled	spled
spled	spled
spled	spled
spleitabl	spletapl
spleitus	spletus
splez	splez
spluzeg	splusegspuseg
spont	spont
spound	spont
spount	spont
Spot	spont
spont	spont
spont	spont
erspount	spont
spountrak	spont
erspont	spont
dreespont	spont
eurspounta	spont
spouronet	spouronet
spouronet	spouronet
spouronus	spouronus
spouronus	spouronus
spouronnuz	spouronus
spouronnuz	spouronus
spurget	spurjaspurji
spurja	spurjaspurji
espurjaz	spurjaspurji
enemspurja	spurjaspurji
spurmantein	spurmanti
spurmantein	spurmanti
stakprenn	stagprenn
stallabour	stallabour
stalamardet	stalabardetstalamardet
stalerez	stalerezh
stlet	stalet
stlaj	staliajstalaj
stalage	staliajstalaj
stanq	stank
stanquennou	stankenn
stankennou	stankenn
Stakenn	stankenn
Staoter	staoter
Lousaounnstauter	staoter
startaat	startaat
startaat	startaat
enemstartaat	startaat
stadudet	statudastatudi
statudi	statudastatudi
stennadur	stennadur
stryou	str
ster	str
stirparft	sterparfet
parft	steredparfet
Steredenni	steredennisteredenna
asteredennaz	steredennisteredenna
steredenna	steredennisteredenna
steredenni	steredennisteredenna
steredenni	steredennisteredenna
steredenna	steredennisteredenna
Steredennein	steredennisteredenna
stirgannc	stergannek
sterad	striadstrad
sternaoter	sternaoter
Sterndor	sterndor
steronid	steronid
steudenetmat	steudennet
teurel	steurel
stigneur	stigner
Stival	Stival
sklabezadurez	stlabezadurezh
sklabezet	stlabezetsklabezet
stlacqou	stlak
o	stof
stocandez	stokandeiz
stocqeresou	stokerez
stolu	stol
stol	stol
stol	stol
stoka	stonka
*staun'c	stonka
Lezdastorlok	storlok
storlog	storlok
stoubenneg	stoubennek
stuiet	stouet
stouet	stouet
stoui	stouistouastouetstouo
estouen	stouistouastouetstouo
stoui	stouistouastouetstouo
stoui	stouistouastouetstouo
stouet	stouistouastouetstouo
astoueas	stouistouastouetstouo
estouent	stouistouastouetstouo
humstouyas	stouistouastouetstouo
stoupaerien	stoupaer
stourmad	stourmad
stourmad	stourmad
stourmad	stourmad
stouvet	stouvet
strac	strak
strak	strak
Strak	strak
strakoudaouarn	strak
strakerienlann	strakerlann
astraclo	strakla
strngouillomp	strangouilha
Strapa	strapastrapat
strapa	strapastrapat
strepet	strapastrapat
strebotus	strebotus
streilhou	streilh
treina	streina
strelikes	strelikez
stribillenna	stribilhenna
stribillenna	stribilhenna
strinkennikarWerc'hez	strinkennigarWerc'hez
stripen	stripenn
stryzdouar	strizhdouar
strobellet	strobella
Strobella	strobella
Stroll	stroll
astrollou	stroll
stronsaet	strosaat
strouilhon	strouilhon
Struz	struzstuz
struz	struzh
struj	struzh
stuyou	stuc'h
Stustuc'h	stuc'h
stultniaich	stultenniaj
soubitamant	subitamant
substantein	substanti
suilhet	suilhasuilhi
Suilla	suilhasuilhi
zuilla	suilhasuilhi
suillaarvirionez	suilhasuilhi
suitteu	suit
jujet	sujed
varsujet	sujed
sul	sul
sulerLaur	SulalLore
zularPuslard	SularPeuzlard
sulc'houel	Sulouel
zulc'houel	Sulouel
zumudi	sumudi
suznryen	suner
suner	suner
sunergwer	sunergwer
enemzunta	sunta
superb	superb
superstition	superstision
superstisionou	superstision
supportein	suporti
humsupportein	suporti
dresuppoz	supoz
surnaturel	surnaturel
surtout	surtout
surtout	surtout
surtout	surtout
suspdus	suspedus
Sutella	sutellasutellat
sutryen	suter
Suzanna	Suzanna
etaenta	'ta
'ta	'ta
Hollata	'ta
Aita	'ta
Asa'tamat	'ta
dabatieren	tabatierenn
tabernacleu	tabernakl
Tabernacl	tabernakl
tachkrok	tachkrog
tadabad	tadabad
dadabat	tadabad
Tadanorgouilhagargaou	tadanorgouilhhagargaou
tadargaou	tadargaouargevier
tadargeier	tadargaouargevier
tadargasoni	tadargasoni
tadcaer	tadkaer
tadkozargaou	Tadkozhargaou
Annderidigez	taeridigezh
Taffou	taf
tafia	tafia
tafia	tafia
dafia	tafia
takezen	takezenn
takezen	takezenn
Taconeu	takon
takon	takon
Takoner	takoner
daconerez	takonerezh
takounerez	takonerezh
takounet	takonet
talant	talant
talantiou	talant
talari	talari
dolbac	talbaktalbok
talmad	talmad
talmeta	talmata
taltouz	taltouz
Taltous	taltouz
talud	talud
talvdus	talvedus
talvouduz	talvoudus
talvouduz	talvoudus
talvouduz	talvoudus
talvouduz	talvoudus
tammtamm	tamtam
tamtam	tamtam
tamallou	tamall
tansacret	tansakret
adano	tana
dana	tana
tana	tana
danan	tana
tana	tana
dana	tana
enemdana	tana
enemdana	tana
andanaven	tanavenn
taneoc'h	tane
kennadanfinfoeltro	tanfinfoeltra
tanflammet	tanflammet
tanflammet	tanflammet
tanfouestras	tanfoestra
Tanijet	tanijet
tanlec'hyou	tanlec'h
c'hwiledtann	tann
tantationeu	tantasion
tantationeu	tantasion
taos	tavouez
tousadein	tavouezadi
taosennet	tavouezennet
taularnan	taolarnev
tldrouk	taoldroug
taulhrre	taolherr
nuntaulherre	taolherr
tallabour	taollabour
taollabour	taollabour
taolru	taolru
taolru	taolru
taoliouru	taolru
taolru	taolru
taolru	taolru
andaolsantel	taolsantel
taulsel	taolsell
taulsl	taolsell
tlzell	taolsell
daolscrifa	taolskriva
taolioboued	taolvoued
anndaolvot	taolvoued
tauxeu	taos
tausseu	taos
taouen	taouen
anndaperien	taper
enemdarafad	tarafat
taran	taran
Taran	taran
Taran	taran
tardamant	tardamant
tardemant	tardamant
Tarieller	tarieller
tarigoz	tarigoz
taros	taros
taltous	tartouz
tarkjertarvokjer	tarvkazh
terhoedeu	tarvhed
tarhgoleud	tarzhgoulodeiz
tarzgolode	tarzhgoulodeiz
tarhereah	tarzherezh
tazou	tas
taad	tasad
dassad	tasad
tassat	tasad
dasado	tasad
tavet	tavet
tawed	tavet
tazata	tazata
daeret	teiret
daeret	teirvet
teisr	teiser
teissr	teiser
tekenn	tek
telegraf	telegraf
delegraf	telegraf
teleskop	teleskop
telescop	teleskop
temjo	temzio
undinrdt	tenerded
endinrdt	tenerded
entenn	tenn
anndenn	tenn
tenneres	tennerezh
tenneris	tenneris
tev	tev
tewalglewet	tevalglevout
tenzorier	tezoriertezorer
tenzorier	tezoriertezorer
denzorier	tezoriertezorer
tivlat	teolad
theologal	teologal
Tereza	Tereza
Thereza	Tereza
MariTereza	Tereza
terinier	terinier
termal	termaltermat
dermat	termaltermat
ederm	termaltermat
termat	termaltermat
terriet	terriet
Ters	ters
Ters	ters
anderzienkart	terzhienngart
anderriengren	terzhienngrin
annderziennleaz	terzhiennlaezh
anderzienvelen	terzhiennvelen
anderzienvelen	terzhiennvelen
derjenvouzar	terzhiennvouzar
anderchenburbuennoc	terzhiennvurbuennek
testeu	test
test	test
aoe	test
dadest	test
tetanos	tetanoz
Ttebie	tetebietetedie
teurgellek	teurbelek
teurbellek	teurbelek
teurnneguedteurennyen	teurenneg
Tsseeu	tez
tjek	tezhiek
tiezhnveg	tihavek
tiezkouez	tikouez
ticouez	tikouez
tilabour	tilabour
tytavarn	titavarn
Thibetad	Tibetad
aotroutiek	tiek
vereurtiek	tiek
mevel	tiek
tyfod	tifoid
dignassenn	tignasenn
tignol	tignol
tignolik	tignol
tillach	tilhaj
papertimbr	timbr
Tineller	tineller
tint	tint
Tital	tintaltinta
tintampar	tintampar
tintennenn	tintenenn
dedirantein	tirantitiranta
tyrandet	tirantitiranta
tirantet	tirantitiranta
andirandiz	tirantiz
tirandus	tirantus
tirennet	tirennet
Tirren'	tirenni
adize	tizha
tao	to
t	to
Tuaillnnneu	toailhenn
tobios	tobioz
Toekennat	toekennad
toked	toked
toloji	toloji
thologi	toloji
tommhatomm	tommhatomm
tomaat	tommaat
tomet	tommaat
tommaat	tommaat
dommadenn	tommadenn
tommadenn	tommadenn
Greomp	tommadenn
tomaden	tommadenn
greateundomaden	tommadenn
eundommaden	tommadenn
obereundommadenn	tommadenn
tuemzer	tommzer
tuemzr	tommzer
tumzer	tommzer
o	ton
toneu	ton
donella	tonella
tonnerdeou	tonerde
tonerde	tonerde
eundonn	tonn
Andonsuren	tosurenn
I	tor
Torr	tor
torreu	tor
tor	tor
tor	tor
Torchdaouarn	torchdaouarn
dorchan	torchatorchi
Torchit	torchatorchi
torchet	torchatorchi
torchennet	torchennet
torchennet	torchennet
teurc'hoezet	torc'hwezet
teurc'huezet	torc'hwezet
Torfttein	torfedi
torgennek	torgennek
torrimelet	torimellet
torr	torr
tor	torr
torrant	torrant
torrant	torrant
torereskraou	torrerezkrao
Tortet	tortet
nedortilleket	tortilha
Bankdoser	tosel
tossenneg	tosennek
Toto	toto
touyadelleu	touadell
undouyadel	touadell
endouadell	touadell
touch	touch
endouchen	touchenn
touchennet	touchennet
touc'het	touc'het
zouellerez	touellerezh
zouellerez	touellerezh
touelluz	touellus
touelluz	touellus
douellus	touellus
touer	touer
touyereah	touerezh
touyereaheu	touerezh
beleiendouet	touet
touet	touet
touet	touet
toezhatoez	touezhatouez
doueserez	touezerezhtouezierezh
toulandar	toullandar
toullarBater	toullarbater
toullober	toullber
toullobez	toullbez
Toullbez	toullbez
toulloubez	toullbez
toulloubouton	toullbouton
toullqah	toullkazh
toullkuz	toullkuzh
Toulllas	toulllas
Toulllouarn	toulllouarn
c'hoaritoulpouliq	toullpoullig
doulltalar	toulltalar
Toulbennik	toullbennig
toumptoumptoump	toump
undoupi	toupi
bodtoupin	toupin
Toupina	toupina
Toupiner	toupiner
touriotan	tourtan
tourtan	tourtan
tourioutan	tourtan
tourc'hach	tourc'haj
torkad	tourked
tourquet	tourked
tourkejou	tourked
Tourqed	tourked
tourtet	tourtaltourta
tourta	tourtaltourta
Tourta	tourtaltourta
Tourtal	tourtaltourta
Tourtal	tourtaltourta
dourchal	tourtaltourta
humdourch	tourtaltourta
enemdourta	tourtaltourta
enemdourtet	tourtaltourta
doutec	touteg
toutek	toutek
tousieret	touziera
tr	tra
Trm	tra
Trabas	trabas
glasktrabasouc'h	trabas
klasktrabasouz	trabas
n'odefetrabasouc'h	trabas
trabasser	trabaser
andrabel	trabell
zrabell	trabell
trabell	trabell
oberhe	trabell
zrabel	trabell
trabellerez	trabellerezh
Trabiden	trabidenn
andradition	tradision
tragidi	trajidi
tracassereah	trakaserezh
dracassereah	trakaserezh
dedraquellat	trakellat
dramailli	tramailhattramailhi
tramzet	tramzet
tranket	tranka
tranquil	trankil
tranqilamant	trankilamant
tranquilite	trankilite
vardranquilite	trankilite
transfiguration	trasfigurasion
edransflammou	trasflamma
transportus	trasportus
drateldrantel	trantell
traouesiou	traouezio
traouillerou	traouilher
traouiller	traouilher
draouillera	traouilhera
trapout	trapout
trapout	trapout
drapout	trapout
trec'h	trec'h
treac'hdeomp	trec'h
etredarz	tredarzha
tredemars	tredemarzh
Entredemarz	tredemarzh
enderdran	trederenn
andrederen	trederenn
andrederen	trederenn
derderann	trederenn
Trguidel	Tregedel
tregondad	tregontad
tregondad	tregontad
dregontet	tregontet
Treiliououarn	treilhhouarn
dreinellat	treinellat
Trelachi	trelachi
tremeniat	tremeniad
tremeniad	tremeniad
Tremeniad	tremeniad
andremenidi	tremeniad
tremeniat	tremeniad
tremenidi	tremeniad
Tremenlec'h	tremenlec'h
zrepaz	trepas
dreicheu	tres
tres	tres
trs	tres
tresou	tres
drejo	tres
dres	tres
tress	tres
oberantress	tres
trestou	trest
Trest	trest
treutkign	treutkign
treuzdidreuz	treuzdidreuz
treuzdidreuz	treuzdidreuz
treuzdidreuzdeh	treuzdidreuz
adreuzdidreuz	treuzdidreuz
trzhatrzd'	treuzhatreuz
adreuzas	treuzitreuza
trezein	treuzitreuza
meadreuzaz	treuzitreuza
treuzi	treuzitreuza
treuzi	treuzitreuza
treuzi	treuzitreuza
dreuzi	treuzitreuza
treuzet	treuzitreuza
etreuzcomze	treuzkomz
treujou	treuzo
dreujou	treuzo
treuzporti	treuzporti
enemdreuzporti	treuzporti
andrevach	trevaj
etrevel	trevell
travel	trevell
tric'hant	tric'hant
tric'hart	tric'hard
Triakler	triakler
tribu	tribu
tribut	tribu
dribu	tribu
endribunal	tribunal
andribunal	tribunal
enndribunal	tribunal
trihateri	trihanteri
triliou	triliv
Trechonei	trichina
trinket	trinket
tripoterez	tripoterezh
trist	trist
trist	trist
Trist	trist
Triouec'het	triwec'het
Triouec'hved	triwec'hvet
driouac'hed	triwec'hvet
troiopleg	trobleg
zroyouplek	trobleg
troiokamm	trogamm
droieukam	trogamm
androzanc	trozas
troadoc'htroadganthi	troadouzhtroad
troc'hgoug	troc'hgouzoug
adrouc'htranch	troc'htrach
adroc'htranch	troc'htrach
Trouc'herbuzuk	troc'herbuzhug
Trouc'herbuzug	troc'herbuzhug
troc'hergoulou	troc'hergoulo
troc'hercoat	troc'herkoad
droherioncoet	troc'herkoad
droet	troet
troet	troet
dromperi	trompiri
drompladurez	trompladurezh
tromplet	tromplet
andromplson	tromplezon
tromplezon	tromplezon
tronket	tronket
tronkolenn	tronkolenn
troubl	troubl
troubl	troubl
troublet	troublet
troublidiguez	troublidigezh
trousqennou	trouskenn
Trouskenna	trouskenna
trousryen	trouzer
truanter	truanter
trubarderez	trubarderezh
trubuillet	trubuilhet
drucheterez	trucheterezh
andruessa	truez
druez	truez
gaouttruezouzomp	truez
gaout	truez
truezouz	truez
truezouzomp	truez
truez	truez
adruez	truez
adruez	truez
eurzelladruez	truez
etrufflint	trufla
druflerez	truflerezh
anndruflerez	truflerezh
truflerezo	truflerezh
eunndrugar	trugar
Trugar	trugar
endruhurulan	truhurul
druillo	truilha
druillia	truilha
truillennek	truilhenneg
truillennog	truilhenneg
truillenneg	truilhennek
druillennek	truilhennek
Truillennok	truilhennek
tuchathatuchat	tuchanthatuchant
tudnez	tudnes
Tugdual	Tudwal
tuffec	tufektufevek
tuffec	tufektufevek
dumia	tumia
tumporelladou	tumporellad
Thuriu	Turiav
turiellerdouar	turiellerdouar
turiellerdouar	turiellerdouar
turierdouar	turierdouar
turriet	turiet
eunturunell	turumellverien
duta	tuta
duta	tuta
huel	uhel
huelglewet	uhelglevout
elfenn	ulvenn
unvan	unvan
Urban	Urban
Urban	Urban
uricinein	urisinaturisini
urzet	urzhet
usmolet	usmolet
I	uz
II	uz
uz	uz
uz	uz
uz	uz
uz	uz
uzachet	uzajet
uzached	uzajet
Uzel	Uzel
usurerez	uzurerezh
usuilleres	uzurerezh
uzulierezo	uzurerezh
quemeretusurerez	uzurerezh
usuret	uzuret
vacabanti	vagabonti
vacabanti	vagabonti
veganet	vaganet
vaille	vailh
vaccina	vaksinavaksini
Vande	Vande
vanr	vaner
vanil	vanilh
vangeancius	vajasius
vangeancius	vajasius
Tehrervant	vant
vantereah	vanterezh
vantrebistac'h	vantrebistac'h
Vantredie	vantredie
vantredistag	vantredistag
vasting	vasting
vastinguet	vastinget
vatand	vatant
vatan	vatant
vtet	vatet
vatet	vatet
evembzec	vembzec
pevna	venaat
venadur	venadur
vnnadur	venadur
venielamant	venielamant
venjansus	vejasusvejasius
venjus	vejus
venjus	vejus
vennoz	vennoz
vnonni	venoni
verandah	veranda
vermisel	vermisel
huet	vet
vete	vete
vete	vete
veuzen	veuzen
viatik	viatik
Vieller	vieller
vikelJesusChrist	vikelJezuzKrist
viquelage	vikelajvikeliaj
vikeleach	vikelajvikeliaj
Vikeliaj	vikelajvikeliaj
victim	viktim
viktim	viktim
victim	viktim
victoret	viktoriviktoari
victorein	viktoriviktoari
evioledou	violedi
violdet	violedi
violanou	violos
viseu	viseu
vincius	visius
vincius	visius
davit	vit
ovit	vit
von	von
von	von
vourlogod	vourlogod
Vovoau	vovo
vovo	vovo
varnedtol	waranhedtaol
warbennneuze	warbennneuze
bosttraon	warboueztrao
warc'horre	warc'horre
varc'horre	warc'horre
Vargorre	warc'horre
wardastoun	wardaston
voardoan	wardoan
warhentenn	wareeuntenn
varentenn	wareeuntenn
vareontenn	wareeuntenn
varentenn	wareeuntenn
Varevelse	warevelse
warhedkalz	warhedkalz
varhedtost	warhedtost
warnij	warnij
warvlar	warvlar
warwintel	warwintel
variun	waryun
wardaro	warzarev
wardaro	warzarev
wardestum	warzastum
varzibrad	warzibrad
varzioual	warziwall
varzoug	warzoug
varzoug	warzoug
wawawa	way
wiq	wig
wiski	wiski
yac'hbeo	yac'hbev
yilc'hierbutun	yalc'hvutun
yalhbutum	yalc'hvutun
yam	yam
ianigou	Yannigo
iaouBask	YaouBaskYaouFask
ioufask	YaouBaskYaouFask
iaoufask	YaouBaskYaouFask
IaouBask	YaouBaskYaouFask
iaouankizi	yaouankizi
iargoz	yargozh
yerdour	yarzour
iec'hedigez	yec'hedigezh
yeinoni	yenoni
ieuet	yeu
ieued	yeu
ieuet	yeu
yohet	yoc'het
yohet	yoc'het
iodbizin	yodbezhin
yodtaryen	yotaer
Youan	Youenn
iouen	Youenn
ioulc'ha	yourc'ha
yourc'hesed	yourc'hez
youst	youst(ek
youstek	youst(ek
yuzerez	yuzerezh
iuzeo	yuzev
zama	zama
zfoyan	zefoyan
zoken	zoken
soken	zoken
zoken	zoken
zomuiken	zomuiken
zomuiken	zomuiken
